日	a
昌	aa
晶	aaa
曝	aate
明	ab
暝	abac
暧	abbe
盟	abbt
晖	abkq
暖	abme
冒	abu
杲	ad
晰	adhl
时	adi
炅	af
影	afhhh
颢	afmbo
晃	afmu
晌	ahbr
眉	ahbu
曛	ahgf
昴	ahhl
剔	ahln
昕	ahml
星	ahqm
昨	ahs
昂	ahul
晷	ahyr
旷	ai
晟	aihs
晡	aijb
既	aimlu
即	aisl
早	aj
昧	ajd
暑	ajka
暄	ajmm
晓	ajpu
晏	ajv
映	akb
旯	aku
显	allt
晁	alyo
旦	am
晒	amcw
旺	amg
戥	ami
旱	amj
昊	amk
昙	ammi
晤	ammr
晨	ammv
昃	amo
量	amwg
是	amyo
晚	anau
暌	anok
晗	aoir
题	aombo
匙	aop
晔	aopj
韪	aoqs
晦	aowy
易	aphh
昆	app
曷	apvo
昀	apy
晴	aqmb
照	arf
暇	arye
昭	ashr
最	asje
昵	asp
曜	asyg
暴	atce
曦	atgs
巴	au
暨	auam
勖	auks
鹛	aupsm
艮	av
垦	avg
歇	avno
恳	avp
曙	awla
曼	awle
暾	aydk
景	ayrf
曩	ayrv
昱	ayt
暗	ayta
月	b
腽	babt
腥	bahm
幂	bakb
胆	bam
肥	bau
冥	bayc
朋	bb
骨	bbb
受	bbe
髅	bbfdv
骼	bbher
髀	bbhhj
骺	bbhmr
骶	bbhpm
骰	bbhue
髓	bbiob
髂	bbjhr
髌	bbjoc
骷	bbjr
髋	bbjtu
爱	bbke
觅	bblu
册	bbm
胴	bbmr
脬	bbnd
舜	bbnq
骱	bboll
鹏	bbpm
鹘	bbpsm
髁	bbwd
髑	bbwli
骸	bbyvo
罕	bcmj
脱	bcru
采	bd
彩	bdhhh
肘	bdi
郛	bdnl
膝	bdoe
乳	bdu
炙	bf
膛	bfbg
脒	bfd
膦	bfdq
胱	bfmu
胖	bfq
滕	bfqe
塍	bfqg
腾	bfqm
媵	bfqv
肚	bg
氍	bghqu
脚	bgil
周	bgr
臌	bgte
膨	bgth
腺	bhae
脓	bhbv
豺	bhdh
胳	bher
貌	bhhau
貉	bhher
肜	bhhh
脾	bhhj
貔	bhhwp
貊	bhmha
貅	bhod
豹	bhpi
胝	bhpm
胜	bhqm
胙	bhs
貂	bhshr
貘	bhtak
肌	bhu
股	bhue
舀	bhx
腴	bhxo
膊	bibi
脏	big
脯	bijb
胧	bikp
脉	bine
腑	bioi
腿	biov
悬	bip
腻	bipo
胎	bir
臁	bitc
虢	biypu
肺	bjb
脖	bjbd
腩	bjbj
膣	bjcg
腔	bjcm
肢	bje
腙	bjmf
腚	bjmo
脘	bjmu
腕	bjnu
膑	bjoc
胺	bjv
冈	bk
胨	bkd
然	bkf
肱	bki
网	bkk
刚	bkln
腌	bklu
胯	bkms
胰	bkn
军	bkq
肋	bks
胁	bksc
肿	bl
腓	blmy
刖	bln
见	blu
胂	blwl
且	bm
胚	bmfm
腼	bmhw
县	bmi
肝	bmj
爰	bmke
助	bmks
删	bmln
具	bmmc
肟	bmms
朊	bmmu
雎	bmog
豚	bmpo
同	bmr
膈	bmrb
冠	bmui
膘	bmwf
腰	bmwv
孚	bnd
豸	bnhh
腱	bnkq
脆	bnmu
肷	bno
胫	bnom
肠	bnsh
冤	bnui
贝	bo
腹	boae
赐	boaph
肭	bob
赠	bocwa
财	bodh
赕	boff
贩	bohe
赂	boher
胗	bohh
贬	bohio
赙	boibi
赃	boig
贼	boij
赇	boije
贱	boim
贻	boir
赌	bojka
贮	bojm
赎	bojnk
贿	bokb
则	boln
脍	bomi
脸	bomm
祭	bommf
赈	bommv
腧	bomn
赋	bompm
赡	boncr
脞	boog
罂	booju
败	book
赊	boomf
购	bopi
账	bopo
贶	borhu
赆	bosoy
赚	botxc
婴	bov
贴	boyr
赔	boytr
赅	boyvo
脂	bpa
胀	bpo
朐	bpr
胞	bpru
肫	bpu
胸	bpuk
用	bq
皲	bqdhe
腠	bqkk
腈	bqmb
郓	bqnl
肤	bqo
甩	bqu
脶	brob
雕	brog
臊	brrd
腭	brrs
脲	bse
服	bsle
凸	bss
皿	bt
腊	bta
膜	btak
腆	btbc
朦	btbo
朕	btk
胼	btt
膳	bttr
罔	btyv
目	bu
眼	buav
瞑	bubac
瞬	bubbq
睬	bubd
睇	bucnh
盼	bucsh
睐	budt
瞠	bufbg
眯	bufd
瞵	bufdq
眇	bufh
睦	bugcg
眭	bugg
瞌	bugit
瞅	buhdf
睥	buhhj
眨	buhio
睡	buhjm
繇	buhvf
瞍	buhxe
睨	buhxu
睃	buice
眸	buihq
眙	buir
睹	bujka
睫	bujlo
瞎	bujqr
眈	bulbu
眺	bulyo
盱	bumd
睚	bumgg
盯	bumn
瞟	bumwf
眄	bumys
瞻	buncr
眵	bunin
瞰	bunjk
睽	bunok
瞪	bunot
睁	bunsd
瞿	buog
矍	buoge
瞧	buogf
睑	buomm
鹞	bupsm
盹	bupu
睛	buqmb
眠	burup
瞩	bushb
眍	busk
眶	busmg
瞒	butlb
瞄	butw
鼎	buvhl
眦	buymp
瞳	buytg
眩	buyvi
妥	bv
奚	bvik
鹦	bvpsm
胭	bwk
胛	bwl
爵	bwli
腮	bwp
丹	by
膪	bybr
膀	bybs
胶	byck
彤	byhhh
肪	byhs
肮	byhu
脐	bykl
胩	bymy
腋	byok
胪	bys
写	bysm
臆	bytp
脑	byuk
臃	byvg
胲	byvo
膻	bywm
金	c
镅	cahu
钽	cam
锝	cami
甑	camuu
锡	caph
锟	capp
钯	cau
银	cav
镘	cawe
钥	cb
锊	cbdi
钢	cbk
锾	cbme
铜	cbmr
锄	cbms
钡	cbo
铡	cbon
钼	cbu
鑫	ccc
锑	ccnh
锐	ccru
铍	cdhe
钵	cdm
铼	cdt
钗	cei
铴	cenh
铎	ceq
钬	cf
销	cfb
镗	cfbg
锁	cfbo
镂	cfdv
锬	cff
钞	cfh
锩	cfqu
铛	cfsm
钍	cg
铂	cha
锦	chab
锹	chdf
锈	chds
钣	che
锋	chej
铬	cher
铥	chgi
锆	chgr
铣	chgu
钐	chhh
铆	chhl
镏	chhw
贝	chie
钎	chj
铢	chjd
锻	chje
锺	chjg
锤	chjm
锸	chjx
剃	chln
锨	chlo
颁	chmbo
财	choy
鹈	chpsm
锇	chqi
铁	chqo
所	chu
镍	chud
钒	chui
铅	chur
铄	chvd
锼	chxe
公	ci
锒	ciav
铖	cihs
铺	cijb
钹	cike
镛	cilb
钱	cim
颂	cimbo
瓮	cimu
链	cioq
镳	cipf
铽	cipp
翁	cisy
镰	citc
镀	cite
钺	ciu
针	cj
镇	cjbc
镲	cjbf
镩	cjcl
镕	cjcr
锗	cjka
铑	cjkp
铐	cjks
锭	cjmo
郸	cjnl
镔	cjoc
铊	cjp
铙	cjpu
钴	cjr
铵	cjv
父	ck
爸	ckau
铕	ckb
镣	ckcf
铩	ckd
斧	ckhml
钛	cki
锛	ckjt
钸	cklb
釜	ckmgc
爹	cknin
爷	cksl
铗	ckt
钟	cl
铿	cleg
钏	clll
镤	cllo
钊	cln
镄	clno
钔	cls
锏	clsa
锎	clst
镧	clsw
铀	clw
铫	clyo
镭	cmbw
钚	cmf
钰	cmgi
铘	cmhl
钉	cmn
钶	cmnr
镉	cmrb
镢	cmto
兮	cmvs
镖	cmwf
镡	cmwj
钲	cmym
钙	cmys
铯	cnau
锰	cndt
钮	cng
镪	cnii
铭	cnir
铤	cnkg
键	cnkq
弟	cnlh
锕	cnlr
钌	cnn
钦	cno
镫	cnot
铮	cnsd
钇	cnu
镥	cnwa
钠	cob
锥	cog
镌	cogs
铃	coii
钤	coin
铨	comg
镎	comq
铪	comr
锉	coog
铧	copj
谷	cor
铋	cph
锪	cphp
钓	cpi
锴	cppa
钝	cpu
钧	cpy
锲	cqhk
铸	cqki
锖	cqmb
兑	crhu
铞	crlb
锃	crmg
欲	crno
锅	crob
总	crp
鹆	crpsm
铝	crr
锷	crrs
分	csh
坌	cshg
贫	csho
忿	cshp
盆	csht
岔	cshu
铒	csj
镊	csje
锯	csjr
锓	csme
铌	csp
钷	csr
钜	css
锔	cssr
错	cta
镆	ctak
铹	ctbs
镒	ctct
镁	ctgk
锘	ctkr
钳	ctm
镬	ctoe
镨	ctta
锚	ctw
钆	cu
铠	cusu
钕	cv
铷	cvr
锱	cvvw
钿	cw
曾	cwa
锞	cwd
锂	cwg
单	cwj
锢	cwjr
铟	cwk
钾	cwl
镯	cwli
锣	cwln
兽	cwmr
锶	cwp
镙	cwvf
钨	cxpm
钋	cy
镑	cybs
镝	cycb
铰	cyck
镦	cydk
钫	cyhs
钪	cyhu
铱	cyhv
锍	cyiu
钭	cyj
铈	cylb
锵	cyli
钻	cyr
镐	cyrb
镶	cyrv
镞	cysk
镟	cyso
铲	cyth
锌	cytj
镱	cytp
锫	cytr
镜	cytu
铉	cyvi
木	d
杳	da
楣	dahu
概	daiu
查	dam
棍	dapp
榻	dasy
杷	dau
根	dav
棚	dbb
栅	dbbm
棘	dbdb
刺	dbln
枧	dblu
桐	dbmr
桴	dbnd
樱	dbov
相	dbu
枣	dby
松	dci
梯	dcnh
林	dd
楂	ddam
棼	ddcsh
森	ddd
焚	ddf
材	ddh
彬	ddhh
梵	ddhui
村	ddi
麓	ddixp
樊	ddk
攀	ddkq
禁	ddmmf
梦	ddni
郴	ddnl
楚	ddnyo
懋	ddp
婪	ddv
楝	ddwf
权	de
树	dedi
桫	defh
柽	deg
杈	dei
颇	dembo
杰	df
梢	dfb
樘	dfbg
榉	dfcq
楼	dfdv
杪	dfh
桄	dfmu
档	dfsm
杜	dg
棱	dgce
樯	dgcw
桂	dgg
樾	dgou
桔	dgr
才	dh
柏	dha
棉	dhab
槔	dhaj
楸	dhdf
皮	dhe
格	dher
梏	dhgr
杉	dhhh
榭	dhhi
柳	dhhl
榴	dhhw
槐	dhi
株	dhjd
椴	dhje
棰	dhjm
栝	dhjr
桥	dhkl
析	dhml
栀	dhmu
柝	dhmy
桁	dhon
柢	dhpm
柞	dhs
檄	dhsk
机	dhu
枫	dhuk
橇	dhuu
栎	dhvd
桕	dhx
寸	di
梭	dice
桩	dig
槭	dihf
榔	diil
栊	dikp
栈	dim
梿	dioq
槌	dior
械	dit
槠	diua
末	dj
檫	djbf
楠	djbj
植	djbm
榕	djcr
榨	djcs
枝	dje
杖	djk
楮	djka
栳	djkp
栲	djks
棕	djmf
楦	djmm
柠	djmn
椟	djnk
槟	djoc
柁	djp
桡	djpu
枯	djr
棺	djrr
桉	djv
栋	dkd
椅	dkmr
整	dkmym
枷	dksr
束	dl
枕	dlbu
棣	dle
皙	dlha
槛	dlit
榄	dliu
剌	dlln
赖	dlnbo
敕	dlok
榈	dlsr
柚	dlw
桃	dlyo
本	dm
桓	dmam
樗	dmbs
檑	dmbw
栖	dmcw
杯	dmf
枰	dmfj
枉	dmg
柘	dmhr
杌	dmhu
桎	dmig
杆	dmj
枥	dmks
梗	dmlk
桠	dmlt
标	dmmf
橱	dmmi
梧	dmmr
柯	dmnr
柄	dmob
橛	dmto
朽	dmvs
橡	dnao
槲	dnbj
桷	dnbq
檐	dncr
李	dnd
橘	dnhb
极	dnhe
桶	dnib
杼	dnin
橄	dnjk
梃	dnkg
楗	dnkq
椭	dnlb
桅	dnmu
橙	dnot
杨	dnsh
楹	dnst
橹	dnwa
枘	dob
榷	dobg
椎	dog
樵	dogf
榫	dogj
柃	doii
杵	doj
枚	dok
栓	domg
桧	domi
检	domm
榆	domn
枞	doo
桦	dopj
枪	dosu
梅	dowy
檎	doyb
杓	dpi
枨	dpo
枇	dpp
楷	dppa
枸	dpr
楔	dqhk
梆	dqjl
椿	dqka
榛	dqkd
楱	dqkk
棒	dqkq
杏	dr
枳	drc
枵	drms
榀	drrr
楫	drsj
榍	dsfb
椰	dsjl
椐	dsjr
枢	dsk
榧	dsly
棂	dsmf
框	dsmg
柩	dsno
柜	dss
杩	dssm
杞	dsu
樨	dsyq
栩	dsyy
来	dt
模	dtak
檬	dtbo
横	dtlc
槿	dtlm
柑	dtm
棋	dtmc
栏	dtmm
椹	dtmv
样	dtq
槎	dtqm
栉	dtsl
槽	dtwa
樽	dtwi
札	du
想	dup
桤	dusu
橼	dvmo
椽	dvno
棵	dwd
柬	dwf
柙	dwl
椤	dwln
楞	dwls
朴	dy
棹	dyaj
桢	dybo
榜	dybs
校	dyck
椒	dyfe
柱	dyg
枋	dyhs
杭	dyhu
梳	dyiu
柿	dylb
槁	dyrb
椁	dyrd
椋	dyrf
栌	dys
榇	dytd
樟	dytj
核	dyvo
檩	dywf
檀	dywm
榱	dywv
水	e
汨	ea
温	eabt
灏	eafo
涅	eag
湄	eahu
溉	eaiu
湿	ealt
混	eapp
渴	eapv
溻	easy
瀑	eate
艰	eav
漫	eawe
溟	ebac
淝	ebau
滑	ebbb
深	ebcd
淫	ebhg
沉	ebhu
滔	ebhx
浑	ebkq
观	eblu
沮	ebm
洞	ebmr
浮	ebnd
溅	ebom
测	ebon
懑	ebp
泪	ebu
濉	ebug
渺	ebuh
溪	ebvk
泻	ebym
淦	ec
滏	eckg
涕	ecnh
浴	ecor
汾	ecsh
湓	ecst
沐	ed
渣	edam
湘	edbu
淞	edci
淋	edd
潸	eddb
漤	eddv
波	edhe
淅	edhl
对	edi
沫	edj
涑	edl
濑	edlo
颡	edmbo
漆	edoe
涞	edt
汉	ee
淼	eee
桑	eeed
叠	eeem
汊	eei
滩	eeog
泽	eeq
婆	eev
消	efb
淌	efbr
瀵	efdc
淡	eff
沙	efh
泮	efq
圣	eg
洼	egg
法	egi
溘	egit
洁	egr
澎	egth
澍	egti
泊	eha
湟	ehag
澳	ehbk
洫	ehbt
洎	ehbu
浓	ehbv
潲	ehdb
湫	ehdf
潘	ehdw
涤	ehed
洚	eheq
洛	eher
烫	ehf
浩	ehgr
洗	ehgu
泖	ehhl
滗	ehhu
派	ehhv
溜	ehhw
泛	ehio
洙	ehjd
活	ehjr
沃	ehk
添	ehkp
沂	ehml
鲨	ehnwm
挲	ehq
湃	ehqj
激	ehsk
没	ehue
沿	ehur
濞	ehut
娑	ehv
泺	ehvd
溲	ehxe
裟	ehyhv
叉	ei
浪	eiav
溥	eibi
浚	eice
梁	eid
粱	eifd
浦	eijb
渗	eikh
泷	eikp
沩	eiks
洲	eill
蚤	eilmi
溏	eilr
浅	eim
泳	eine
涟	eioq
怼	eip
治	eir
沪	eis
濂	eitc
渡	eite
浒	eiuj
泼	eive
漉	eixp
汁	ej
沛	ejb
滇	ejbc
溶	ejcr
渤	ejds
潮	ejjb
瀚	ejjy
渚	ejka
渖	ejll
演	ejmc
淙	ejmf
渲	ejmm
泞	ejmn
淀	ejmo
浣	ejmu
渎	ejnk
滨	ejoc
沱	ejp
浇	ejpu
沽	ejr
湖	ejrb
涫	ejrr
滓	ejyj
洧	ekb
鋈	ekc
潦	ekcf
潴	ekha
漪	ekhr
汰	eki
浠	ekkb
淹	eklu
渐	ekql
劝	eks
浃	ekt
沈	elbu
渊	elfl
滥	elit
沸	elln
漶	ellp
浊	elmi
溃	elmo
津	elq
涧	elsa
润	elsg
澜	elsw
油	elw
洮	elyo
江	em
洹	emam
濡	embb
酒	emcw
汪	emg
涯	emgg
源	emhf
湎	emhw
汗	emj
沥	emks
沔	emls
溽	emmi
浯	emmr
污	emms
沅	emmu
汀	emn
洌	emnn
河	emnr
鸿	empm
涿	empo
溧	emwd
漂	emwf
湮	emwg
潭	emwj
浼	enau
涣	enbk
澹	encr
汲	enhe
汐	eni
涌	enib
澉	enjk
汛	enju
涎	enkm
邓	enl
滁	enld
泐	enls
渌	enme
欢	eno
泾	enom
澄	enot
涨	enpo
汤	ensh
涵	enue
渔	enwm
溺	enyy
溆	eode
难	eog
泠	eoii
濮	eolo
瀹	eomb
浜	eomc
涂	eomd
浍	eomi
潋	eomk
渝	eomn
洽	eomr
汔	eonu
沦	eop
沲	eopd
沧	eosu
汽	eou
海	eowy
沁	ep
洵	epa
池	epd
泌	eph
沟	epi
淘	epou
泡	epru
沏	epsh
鸡	epsm
泄	ept
渫	eptd
沌	epu
浙	eqhl
沣	eqj
滟	eqju
溱	eqkd
涛	eqki
清	eqmb
渍	eqmo
潜	eqoa
涓	erb
渑	erlu
潞	ermr
涡	erob
澡	errd
汜	eru
泯	erup
浞	eryo
汇	es
涮	esbn
渠	esd
沼	eshr
涩	esim
洱	esj
滠	esje
沤	esk
漏	esmb
浸	esme
渥	esmg
浔	esmi
潺	esnd
泥	esp
濯	esyg
漠	etak
潆	etbf
滢	etbg
湔	etbn
涝	etbs
洪	etc
澌	etcl
溢	etct
港	etcu
漾	etge
漭	etit
滞	etjb
满	etlb
潢	etlc
潇	etlx
泔	etm
淇	etmc
湛	etmv
洋	etq
灌	etrg
溯	etub
滋	etvi
漕	etwa
澧	etwt
汕	eu
鎏	euc
染	eud
汹	euk
湍	eumb
涔	euon
汝	ev
潍	evmg
洳	evr
淄	evvw
渭	ewb
泗	ewc
涸	ewjr
洇	ewk
淠	ewml
溷	ewmo
泅	ewo
涠	ewqs
洄	ewr
漯	ewvf
淖	eyaj
澈	eybk
浈	eybo
滂	eybs
滴	eycb
滦	eycd
湾	eycn
滚	eycv
瀣	eyem
淑	eyfe
注	eyg
濒	eyho
沆	eyhu
流	eyiu
汶	eyk
济	eykl
浏	eykn
涉	eylh
淬	eyoj
液	eyok
滹	eypd
滤	eypp
沾	eyr
淳	eyrd
濠	eyro
瀛	eyru
泸	eys
游	eysd
漩	eyso
淤	eysy
泣	eyt
潼	eytg
漳	eytj
涪	eytr
漓	eyub
泫	eyvi
澶	eywm
汴	eyy
火	f
焊	famj
爆	fate
熳	fawe
煜	fayt
肖	fb
觉	fbblu
泶	fbe
喾	fbhgr
燃	fbkf
削	fbln
尝	fbmmi
学	fbnd
鲎	fbnwm
敝	fbok
尚	fbr
赏	fbrbo
棠	fbrd
堂	fbrg
党	fbrhu
常	fbrlb
掌	fbrq
裳	fbryv
黉	fbtlc
爝	fbwi
脊	fcb
举	fcq
誉	fcymr
米	fd
粑	fdau
粗	fdbm
粉	fdcsh
粿	fdwd
粕	fdha
糗	fdhuk
糌	fdhya
粮	fdiav
糁	fdikh
糠	fdile
糖	fdilr
糙	fdior
粽	fdjmf
糊	fdjrb
类	fdk
糯	fdmbb
粞	fdmcw
粳	fdmlk
粝	fdmms
籽	fdnd
糅	fdnhd
糨	fdnii
糈	fdnob
敉	fdok
糇	fdonk
精	fdqmb
粪	fdtc
糕	fdtgf
糍	fdtvi
糟	fdtwa
籼	fdu
娄	fdv
料	fdyj
粹	fdyoj
粘	fdyr
粒	fdyt
炎	ff
燮	ffe
焱	fff
炒	ffh
剡	ffln
郯	ffnl
灶	fg
少	fh
煌	fhag
燠	fhbk
省	fhbu
燔	fhdw
烽	fhej
烙	fher
烀	fhfd
熘	fhhw
煅	fhje
劣	fhks
炸	fhs
熄	fhup
烁	fhvd
燧	fioo
煺	fiov
炉	fis
煸	fisb
煽	fisy
熔	fjcr
烤	fjks
煊	fjmm
烷	fjmu
烧	fjpu
煳	fjrb
尖	fk
瞥	fkbu
燎	fkcf
尜	fkf
氅	fkhqu
烯	fkkb
鳖	fknwm
憋	fkp
蹩	fkryo
弊	fkt
炼	fkvd
烛	flmi
焖	flsp
烦	fmbo
兴	fmc
炻	fmhr
光	fmhu
焐	fmmr
灯	fmn
炳	fmob
焕	fnbk
焰	fnhx
炊	fno
烃	fnom
炀	fnsh
雀	fog
焓	foir
烩	fomi
烨	fopj
炝	fosu
灼	fpi
炮	fpru
炖	fpu
半	fq
眷	fqbu
桊	fqd
叛	fqhe
判	fqln
豢	fqmpo
鲞	fqnwm
拳	fqq
炜	fqs
券	fqsh
卷	fqsu
粼	fqvv
誊	fqymr
炽	frc
燥	frrd
当	fsm
烬	fsoy
炬	fss
熠	fsya
烘	ftc
煤	ftmd
烂	ftmm
烊	ftq
灿	fu
辉	fubkq
耀	fusyg
数	fvok
烟	fwk
煨	fwmv
焯	fyaj
熵	fycb
炷	fyg
炕	fyhu
焙	fytr
炫	fyvi
土	g
埘	gadi
声	gah
坦	gam
堤	gamo
埸	gaph
塌	gasy
垠	gav
墁	gawe
冉	gb
堋	gbb
埒	gbdi
悫	gbhp
壳	gbhu
觳	gbhue
壶	gblt
垌	gbmr
壹	gbmt
坝	gbo
坍	gby
赫	gcglc
赭	gcjka
郝	gcnl
赦	gcok
赧	gcsle
丧	gcv
增	gcwa
啬	gcwr
坡	gdhe
寺	gdi
块	gdk
瞽	gebu
馨	gehda
鼙	gehhj
墚	geid
磬	gemhr
罄	geoju
謦	geymr
款	gfno
圭	gg
墙	ggcw
封	ggdi
恚	ggp
卦	ggy
垧	ghbr
坂	ghe
埤	ghhj
圻	ghml
垢	ghmr
甏	ghmuu
坼	ghmy
坻	ghpm
埠	ghrj
垛	ghud
去	gi
盍	gibt
城	gihs
埔	gijb
垅	gikp
劫	giks
墉	gilb
塘	gilr
埃	giok
域	girm
却	gisl
填	gjbc
埴	gjbm
堵	gjka
垸	gjmu
坨	gjp
螫	gklmi
埯	gklu
垮	gkms
埭	gle
圳	glll
赤	glnc
坤	glwl
垣	gmam
圩	gmd
坏	gmf
坪	gmfj
坯	gmfm
塬	gmhf
垤	gmig
坜	gmks
埂	gmlk
垭	gmlt
坛	gmmi
圬	gmms
坷	gmnr
塥	gmrb
堙	gmwg
圾	gnhe
彀	gnhue
埏	gnkm
坎	gno
场	gnsh
堍	gnui
趄	gobm
趟	gofbr
堆	gog
趱	gohuo
埝	goip
越	goiu
赵	gok
赶	gomj
趔	gomnn
堠	gonk
趋	gonsm
圪	gonu
趁	goohh
超	goshr
趣	gosje
起	gosu
赳	govl
赴	goy
趑	goyno
志	gp
地	gpd
堞	gptd
均	gpy
毂	gqhue
吉	gr
	zzzz
埙	grbo
袁	grhv
颉	grmbo
埕	grmg
埚	grob
熹	grtf
喜	grtr
圯	gru
堰	gsav
埽	gsmb
坭	gsp
圮	gsu
堀	gsuu
墀	gsyq
彭	gthhh
幸	gtj
鼓	gtje
坩	gtm
堪	gtmv
塔	gtor
懿	gtyop
垲	gusu
坳	gvis
埋	gwg
塄	gwls
坶	gwyi
坞	gxpm
盐	gybt
墒	gycr
墩	gydk
坊	gyhs
坑	gyhu
坟	gyk
址	gylm
走	gyo
墟	gypt
坫	gyr
壕	gyro
壤	gyrv
垆	gys
垃	gyt
培	gytr
境	gytu
垴	gyuk
垓	gyvo
竹	h
白	ha
泉	hae
皤	hahdw
皈	hahe
皓	hahgr
魄	hahi
皖	hajmu
皋	hakj
帛	halb
笪	ham
皇	hamg
馥	haoae
皂	hap
的	hapi
笆	hau
皑	hausu
簋	havt
皎	hayck
爨	hbddf
奥	hbk
筋	hbks
制	hbln
笕	hblu
璺	hbmgi
筒	hbmr
向	hbr
血	hbt
自	hbu
纂	hbuf
篡	hbui
算	hbut
农	hbv
舟	hbyi
箪	hcwj
禾	hd
香	hda
策	hdb
稠	hdbgr
稻	hdbhx
租	hdbm
稃	hdbnd
箱	hdbu
税	hdcru
秣	hddj
释	hdeq
秋	hdf
稍	hdfb
秒	hdfh
穑	hdgcw
秸	hdgr
穆	hdhah
稗	hdhhj
秩	hdhqo
秃	hdhu
私	hdi
稂	hdiav
秫	hdid
稽	hdiua
嵇	hdiuu
稹	hdjbc
穗	hdjip
稼	hdjmo
秧	hdkb
稀	hdkkb
秉	hdl
利	hdln
籁	hdlo
乘	hdlp
釉	hdlw
秭	hdlxh
笨	hdm
秤	hdmfj
秆	hdmj
季	hdnd
称	hdnf
秀	hdnhs
移	hdnin
邾	hdnl
稳	hdnsp
黍	hdoe
稚	hdog
稔	hdoip
悉	hdp
秘	hdph
秕	hdpp
和	hdr
积	hdrc
程	hdrmg
稆	hdrr
秽	hduni
委	hdv
番	hdw
稷	hdwce
稞	hdwd
科	hdyj
稿	hdyrb
穰	hdyrv
反	he
条	hed
箔	heha
簿	heii
务	heks
磐	hemhr
各	her
备	hew
惫	hewp
冬	hey
黏	heyr
筲	hfb
乎	hfd
篓	hfdv
愁	hfp
壬	hg
等	hgdi
熏	hgf
先	hghu
丢	hgi
筠	hgpy
告	hgr
靠	hgrly
篁	hhag
卿	hhail
贸	hhbo
射	hhdi
躺	hhfbr
筅	hhgu
彡	hhh
躲	hhhud
卑	hhj
笑	hhk
笊	hhlo
须	hhmbo
躬	hhn
黎	hhoe
笙	hhqm
笔	hhqu
笮	hhs
躯	hhsk
卯	hhsl
孵	hhsld
卵	hhsli
篼	hhvu
留	hhw
黧	hhwgf
篦	hhwp
篪	hhyu
鬼	hi
魍	hibtv
魈	hifb
箴	hihr
魃	hiike
魅	hijd
笼	hikp
笺	him
魉	himob
乏	hino
篷	hioj
笾	hios
鹅	hipsm
笞	hir
篇	hisb
簏	hixp
魁	hiyj
魑	hiyub
千	hj
质	hjbo
盾	hjbu
箜	hjcm
朱	hjd
段	hjhue
箸	hjka
乖	hjlp
郫	hjnl
箢	hjnu
鹎	hjpsm
舌	hjr
管	hjrr
翱	hjsyy
垂	hjtm
重	hjwg
夭	hk
乔	hkll
吞	hkr
笳	hksr
岙	hku
币	hlb
禹	hlbi
齄	hldam
篮	hlit
鼽	hlku
筛	hllb
颀	hlmbo
鼾	hlmj
篑	hlmo
欣	hlno
爪	hlo
简	hlsa
笛	hlw
箫	hlx
笫	hlxh
眚	hmbu
竽	hmd
筑	hmhu
毁	hmhue
竿	hmj
斤	hml
筻	hmlk
竺	hmm
筇	hmnl
筮	hmoo
惩	hmp
鸱	hmpsm
后	hmr
卮	hmsu
笄	hmt
簪	hmua
篥	hmwd
簟	hmwj
甥	hmwks
斥	hmy
梨	hnd
笈	hnhe
犁	hnhq
筵	hnkm
第	hnlh
簦	hnot
愆	hnp
掣	hnq
筝	hnsd
八	ho
得	hoami
爬	hoau
很	hoav
衢	hobgn
徂	hobm
徭	hobou
衔	hocmn
彼	hodhe
符	hodi
徕	hodt
衍	hoemn
徜	hofbr
待	hogdi
街	hoggn
徒	hogyo
徨	hohag
循	hohju
瓞	hohqo
徼	hohsk
役	hohue
筏	hoi
德	hojwp
筱	holk
徘	holmy
律	holq
筌	homg
签	homm
行	hommn
答	homr
衙	homrn
征	homym
篌	honk
衡	honkn
径	honom
徐	hoomd
御	hooml
徇	hopa
彻	hopsh
徉	hotq
徽	houfk
徵	hougk
微	houuk
後	hovie
徊	howr
往	hoyg
彷	hoyhs
徙	hoylo
乇	hp
昏	hpa
筷	hpdk
笏	hphh
剩	hpln
氐	hpm
筚	hppj
笱	hpr
印	hpsl
牛	hq
筢	hqau
犋	hqbmc
看	hqbu
籍	hqda
箨	hqeq
牡	hqg
特	hqgdi
牿	hqhgr
牲	hqhqm
牦	hqhqu
籀	hqhw
我	hqi
犏	hqisb
犊	hqjnk
牯	hqjr
筹	hqki
犄	hqkmr
生	hqm
箐	hqmb
牺	hqmcw
牾	hqmmr
箦	hqmo
拜	hqmqj
犍	hqnkq
失	hqo
牧	hqok
牝	hqp
物	hqphh
筘	hqr
箍	hqsb
箝	hqtm
毛	hqu
犒	hqyrb
舔	hrhkp
舐	hrhup
阜	hrj
刮	hrln
郜	hrnl
雒	hrog
敌	hrok
鹄	hrpsm
甜	hrtm
乱	hru
辞	hrytj
乍	hs
所	hshml
笤	hshr
殷	hshue
笋	hsk
箧	hskt
篚	hsly
筐	hsmg
笥	hsmr
敫	hsok
怎	hsp
笸	hsr
笃	hssm
升	ht
箭	htbn
簸	htce
衅	htfq
箬	htkr
簧	htlc
劓	htln
箕	htmc
衄	htng
篝	httb
几	hu
鼹	huajv
飓	hubmc
赞	hubo
鼷	hubvk
鼢	hucsh
朵	hud
殳	hue
毯	huff
飚	hufff
凰	huhag
毳	huhuu
飕	huhxe
凡	hui
毪	huihq
臭	huik
瓜	huio
风	huk
鼬	hulw
颓	humbo
鼯	hummr
夙	humni
毽	hunkq
氇	hunwa
息	hup
飑	hupru
氆	hutta
鼻	huwml
乐	hvd
簖	hvdl
魏	hvhi
兜	hvhu
系	hvif
篆	hvno
睾	hwgtj
囟	hwk
篾	hwli
箩	hwln
箅	hwml
粤	hwmvs
囱	hwni
鄱	hwnl
翻	hwsyy
臼	hx
盥	hxbt
身	hxh
舆	hxkc
叟	hxle
歃	hxno
臾	hxo
舄	hxpf
舁	hxt
鼠	hxuyu
舅	hxwks
昝	hya
舰	hyblu
盘	hybt
艄	hyfb
舶	hyha
舨	hyhe
舴	hyhs
般	hyhue
船	hyhur
艘	hyhxe
舣	hyik
舵	hyjp
舯	hyl
螽	hylii
舳	hylw
舡	hym
舾	hymcw
舸	hymnr
艋	hyndt
艇	hynkg
舱	hyosu
舭	hypp
咎	hyr
篙	hyrb
艉	hyshu
簇	hysk
笠	hyt
艨	hytbo
艏	hythu
艚	hytwa
舢	hyu
篱	hyub
舫	hyyhs
航	hyyhu
舻	hyys
艟	hyytg
舷	hyyvi
戈	i
良	iav
能	ibpp
翩	ibsyy
术	id
麻	idd
糜	iddd
縻	iddf
麽	iddi
摩	iddq
磨	iddr
麾	iddu
靡	iddy
书	ids
昶	iea
皴	iedhe
救	ieok
裘	ieyhv
视	ifblu
祖	ifbm
禅	ifcwj
社	ifg
祛	ifgi
禧	ifgrr
祆	ifhk
祈	ifhml
祗	ifhpm
祚	ifhs
祓	ifike
祜	ifjr
神	iflwl
祧	iflyo
应	ifm
福	ifmrw
祢	ifnf
祁	ifnl
禄	ifnme
鹧	ifpsm
禊	ifqhk
祷	ifqki
祝	ifrhu
祸	ifrob
祀	ifru
蹙	ifryo
祠	ifsmr
禚	iftgf
祺	iftmc
祥	iftq
礼	ifu
祯	ifybo
祉	ifylm
禳	ifyrv
庄	ig
戊	ih
庳	ihhj
毵	ihhqu
戍	ihi
戌	ihm
咸	ihmr
威	ihmv
底	ihpm
牟	ihq
成	ihs
臧	ihsll
允	ihu
庾	ihxo
戚	ihymf
朗	iib
垒	iiig
廊	iiil
庞	iikp
郎	iinl
庐	iis
废	iive
戎	ij
甫	ijb
求	ije
犬	ik
参	ikhhh
飙	ikhuk
肇	iklq
庵	iklu
叁	ikmmm
龙	ikp
库	ikq
为	iksi
尤	iku
綮	ikvif
畚	ikw
庸	ilb
康	ile
州	ilil
划	iln
庚	ilo
赓	iloo
唐	ilr
庙	ilw
戋	im
盏	imbt
庑	imku
惑	imp
廨	inbq
永	ine
序	inin
庭	inkg
邝	inl
之	ino
暹	ioaog
遏	ioapv
遢	ioasy
退	ioav
邈	iobhu
遥	iobou
迥	iobr
递	iocnh
庥	iod
过	iodi
速	iodl
逍	iofb
迷	iofd
遴	iofdq
膺	iogb
逵	iogcg
鹰	iogm
迫	ioha
遑	iohag
透	iohds
逶	iohdv
返	iohe
逢	iohej
逄	ioheq
造	iohgr
选	iohgu
遛	iohhw
迁	iohj
适	iohjr
遁	iohju
近	iohml
逅	iohmr
迭	iohqo
追	iohrr
迮	iohs
邀	iohsk
迎	iohul
腐	ioib
逡	ioice
述	ioid
逋	ioijb
逑	ioije
迨	ioir
遍	ioisb
遮	ioitf
邃	iojco
逭	iojrr
矣	iok
逖	iokhf
逛	iokhg
连	iokq
边	ioks
迦	ioksr
逮	iole
遗	iolmo
遣	iolmr
迪	iolw
逃	iolyo
逦	iombb
迂	iomd
还	iomf
迈	iomhs
运	iommi
远	iommu
逐	iompo
逗	iomrt
逼	iomrw
迓	iomvh
邂	ionbq
逊	iondf
迩	ionf
通	ionib
迅	ionju
逯	ionme
辽	ionn
迳	ionom
逸	ionui
座	ioog
迕	iooj
途	ioomd
逾	ioomn
迄	ioonu
迤	ioopd
逝	ioqhl
违	ioqs
遨	ioqsk
逞	iormg
遐	iorye
迢	ioshr
迟	ioso
避	iosrj
遒	iotcw
道	iothu
送	iotk
遂	iotpo
进	iott
遘	iottb
逆	iotu
遭	iotwa
遵	iotwi
遄	ioumb
邋	iovvu
巡	iovvv
遇	iowlb
逻	iowln
这	ioyk
迹	ioylc
遽	ioypo
弋	ip
鏖	ipc
熊	ipf
麋	ipfd
麟	ipfdq
垄	ipg
麇	iphd
麝	iphhi
麂	iphu
式	ipm
砻	ipmhr
贰	ipmmo
庇	ipp
鸢	ippsm
庖	ipru
聋	ipsj
龚	iptc
甙	iptm
麒	iptmc
麈	ipyg
袭	ipyhv
廒	iqsk
台	ir
炱	irf
或	irm
感	irp
户	is
肩	isb
扃	isbr
扁	isbt
戾	isik
扉	islmy
雇	isog
敷	isok
启	isr
扈	israu
扇	issyy
廖	isyh
房	isyhs
戽	isyj
戒	it
度	ite
庶	itf
席	itlb
廑	itlm
庠	itq
庹	itso
廉	itxc
讠	iu
谒	iuapv
谩	iuawe
调	iubgr
诨	iubkq
诅	iubm
谖	iubme
谣	iubou
讼	iuci
说	iucru
讨	iudi
诀	iudk
谏	iudwf
译	iueq
诮	iufb
谠	iufbu
谈	iuff
诗	iugdi
诖	iugg
诘	iugr
诱	iuhds
诿	iuhdv
诰	iuhgr
诜	iuhgu
谢	iuhhi
诛	iuhjd
话	iuhjr
诟	iuhmr
诉	iuhmy
诋	iuhpm
诈	iuhs
讥	iuhu
设	iuhue
讽	iuhuk
谀	iuhxo
诚	iuihs
议	iuik
谜	iuiod
诶	iuiok
谴	iuior
试	iuipm
诒	iuir
谝	iuisb
诫	iuit
计	iuj
谳	iujbk
谊	iujbm
诧	iujhp
诸	iujka
读	iujnk
诂	iujr
诙	iukf
诳	iukhg
训	iulll
诽	iulmy
谰	iulsw
讧	ium
评	iumfj
讦	iumj
语	iummr
订	iumn
诃	iumnr
诬	iumoo
诼	iumpo
谮	iumua
讶	iumvh
谭	iumwj
证	iumym
谵	iuncr
谲	iunhb
谄	iunhx
诵	iunib
讯	iunju
诞	iunkm
诡	iunmu
诤	iunsd
诌	iunsm
谗	iunuy
认	iuo
讷	iuob
谁	iuog
谯	iuogf
诊	iuohh
谶	iuoim
谂	iuoip
许	iuoj
诠	iuomg
谕	iuomn
讫	iuonu
论	iuop
诲	iuowy
询	iupa
谧	iupht
谐	iuppa
谍	iuptd
诔	iuqd
请	iuqmb
讳	iuqs
识	iurc
误	iurmk
谔	iurrs
诏	iushr
诹	iusje
讴	iusk
诓	iusmg
词	iusmr
讵	iuss
记	iusu
谬	iusyh
诩	iusyy
谟	iutak
谫	iutbh
谥	iutct
诺	iutkr
谨	iutlm
谋	iutmd
谌	iutmv
详	iutq
讲	iutt
谱	iutta
谦	iutxc
谎	iutyu
讪	iuu
诎	iuuu
谓	iuwb
谡	iuwce
课	iuwd
讣	iuy
谛	iuybb
谤	iuybs
谪	iuycb
谚	iuyhh
访	iuyhs
让	iuym
谇	iuyoj
谘	iuyor
谑	iuypm
谆	iuyrd
谅	iuyrf
谙	iuyta
该	iuyvo
发	ivke
廛	iwcg
鹿	ixp
疒	iy
瘟	iyabt
疸	iyam
疤	iyau
痕	iyav
疽	iybm
瘵	iybof
瘿	iybov
痈	iybq
癯	iybug
瘅	iycwj
疲	iydhe
廓	iydl
瘌	iydln
癞	iydlo
痧	iyefh
瘙	iyeii
瘫	iyeog
瘠	iyfcb
瘘	iyfdv
痰	iyff
痔	iygdi
痣	iygp
痢	iyhdn
痿	iyhdv
疼	iyhey
瘤	iyhhw
痄	iyhs
疫	iyhue
疯	iyhuk
瘪	iyhup
瘦	iyhxe
瘐	iyhxo
瘢	iyhye
疣	iyiku
癫	iyjco
痍	iykn
瘸	iykrb
痂	iyksr
瘗	iyktg
痱	iylmy
痫	iylsd
痞	iymfr
癍	iymgg
疠	iymhs
疬	iymks
痖	iymlt
痦	iymmr
疔	iymn
疴	iymnr
病	iymob
瘃	iympo
痘	iymrt
瘭	iymwf
症	iymym
痪	iynbk
痛	iynib
癃	iynlm
瘾	iynlp
癣	iynmq
疗	iynn
疚	iyno
痉	iynom
疡	iynsh
疹	iyohh
疾	iyok
痴	iyokr
疥	iyoll
痊	iyomg
瘊	iyonk
疙	iyonu
痤	iyoog
疮	iyosu
疱	iypru
瘛	iyqhp
店	iyr
癌	iyrru
瘕	iyrye
癜	iysce
疖	iysl
疟	iysm
癖	iysrj
瘳	iysyh
瘼	iytak
痨	iytbs
癀	iytlc
疳	iytm
瘩	iytor
痒	iytq
瘥	iytqm
疝	iyu
廪	iywf
痼	iywjr
痹	iywml
瘰	iywvf
疰	iyyg
疵	iyymp
瘁	iyyoj
瘀	iyysy
瘴	iyytj
癔	iyytp
痃	iyyvi
十	j
煮	jaf
都	janl
翥	jasyy
宴	jav
赍	jbbo
献	jbik
宜	jbm
真	jbmc
直	jbmm
橐	jbmrd
蠹	jbmri
孛	jbnd
察	jbof
囊	jbrrv
南	jbtj
索	jbvif
穴	jc
窭	jcfdv
窖	jchgr
窆	jchio
窳	jchoo
窄	jchs
窗	jchwn
突	jcik
窦	jcjnk
穷	jcks
究	jcku
帘	jclb
窜	jcll
窕	jclyo
空	jcm
颠	jcmbo
窒	jcmig
窍	jcmms
穿	jcmvh
穹	jcn
穸	jcni
窿	jcnlm
窑	jcoju
窬	jcomn
容	jcor
窃	jcpsh
窀	jcpu
窥	jcqou
窝	jcrob
窘	jcskr
窟	jcsuu
窈	jcvis
窠	jcwd
窨	jcyta
未	jd
守	jdi
勃	jdks
教	jdok
鹁	jdpsm
支	je
墼	jeg
翅	jesyy
灾	jf
宵	jfb
客	jher
宪	jhgu
宅	jhp
牢	jhq
博	jibi
栽	jid
宠	jikp
载	jikq
截	jiog
惠	jip
哉	jir
戴	jiwtc
裁	jiyhv
朝	jjb
戟	jji
乾	jjonu
翰	jjosy
斡	jjoyj
韩	jjqs
軎	jjr
丈	jk
者	jka
宥	jkb
觌	jkblu
寮	jkcf
宏	jki
寄	jkmr
嫠	jkmv
孝	jknd
老	jkp
协	jksc
宄	jku
考	jkys
吏	jlk
事	jlln
妻	jlv
宙	jlw
审	jlwl
士	jm
宣	jmam
寡	jmch
宇	jmd
宝	jmgi
宕	jmhr
室	jmig
矗	jmjmm
寅	jmlc
宗	jmmf
完	jmmu
宸	jmmv
宁	jmn
家	jmpo
富	jmrw
寇	jmue
定	jmyo
字	jnd
宛	jniu
麴	jnpfd
卖	jnyk
宿	joma
宾	jomc
它	jp
耆	jpa
甯	jpbq
宓	jph
蜜	jphi
耄	jphqu
密	jphu
尧	jpmhu
耋	jpmig
害	jqmr
古	jr
胡	jrb
鹕	jrbpm
豁	jrcor
克	jrhu
割	jrln
官	jrlr
额	jrmbo
故	jrok
鸪	jrpsm
宫	jrr
嘏	jrrye
辜	jrytj
宦	jsll
寥	jsyh
卉	jt
寞	jtak
贲	jtbo
宽	jtbu
寨	jtcd
塞	jtcg
骞	jtcm
赛	jtco
搴	jtcq
謇	jtcr
褰	jtcv
寒	jtcy
七	ju
兢	jujru
翘	jusyy
安	jv
案	jvd
寐	jvhd
寤	jvhr
寓	jwlb
寰	jwlv
寂	jyfe
实	jyk
寝	jyle
宰	jytj
大	k
有	ka
橥	kad
有	kb
盎	kbbt
牵	kbhq
郗	kbnl
欷	kbno
鸯	kbpsm
东	kd
夺	kdi
弑	kdipm
刹	kdln
鸫	kdpsm
友	ke
灰	kf
盔	kfbt
鹩	kfpsm
奎	kgg
猖	khaa
猩	khahm
猸	khahu
狠	khav
猾	khbbb
狙	khbm
狈	khbo
猹	khdam
獭	khdlo
狄	khf
猿	khgrv
猁	khhdn
獯	khhgf
狐	khhuo
猊	khhxu
犷	khi
狼	khiav
狻	khice
狁	khihu
狨	khij
犹	khiku
狱	khiuk
狩	khjdi
猪	khjka
狞	khjmn
猢	khjrb
獠	khkcf
猗	khkmr
狭	khkt
犰	khku
狮	khllb
狒	khlln
独	khlmi
狂	khmg
犴	khmj
獗	khmto
獬	khnbq
狲	khndf
猛	khndt
狃	khng
猱	khnhd
猕	khnnf
狰	khnsd
狳	khomd
狯	khomi
猃	khomm
猞	khomr
猴	khonk
狴	khppg
狗	khpr
狍	khpru
猜	khqmb
狷	khrb
犸	khssm
犯	khsu
猎	khta
獾	khtrg
猫	khtw
猬	khwb
猓	khwd
狸	khwg
狎	khwl
猡	khwln
猥	khwmv
狡	khyck
狺	khymr
猝	khyoj
獐	khytj
獍	khytu
太	ki
健	kin
郄	kinl
雄	kiog
态	kip
奢	kjka
奔	kjt
爻	kk
肴	kkb
爽	kkkk
希	kklb
夯	kks
暂	kla
布	klb
錾	klc
椠	kld
在	klg
夼	klll
刈	kln
存	klnd
奄	klwu
左	km
奈	kmmf
夸	kmms
奇	kmnr
夷	kn
车	kq
辊	kqapp
辋	kqbtv
轰	kqee
辍	kqeee
辚	kqfdq
辕	kqgrv
辂	kqher
轷	kqhfd
轿	kqhkl
斩	kqhml
轶	kqhqo
轹	kqhvd
辅	kqijb
轼	kqipm
辘	kqixp
辖	kqjqr
轱	kqjr
轨	kqku
轴	kqlw
轾	kqmig
轩	kqmj
轲	kqmnr
辆	kqmob
辐	kqmrw
轭	kqmsu
软	kqno
轻	kqnom
轸	kqohh
辁	kqomg
输	kqomn
轮	kqop
辏	kqqkk
转	kqqni
轵	kqrc
辑	kqrsj
轫	kqshi
轺	kqshr
辄	kqsju
辗	kqstv
轧	kqu
辎	kqvvw
辙	kqybk
较	kqyck
轳	kqys
右	kr
贺	krbo
架	krd
剞	krln
哿	krmnr
欹	krno
驾	krssm
袈	kryhv
力	ks
办	ksc
瓠	kshuo
耷	ksj
奁	ksk
刳	ksln
套	ksmi
匏	kspru
加	ksr
勰	kswp
夹	kt
颊	ktmbo
郏	ktnl
九	ku
旭	kua
杂	kud
丸	kui
尴	kulit
尬	kuoll
尥	kupi
鹌	kupsm
馗	kuthu
奋	kw
中	l
旧	la
权	lai
巾	lb
冖	zzzz
帽	lbabu
幌	lbafu
幔	lbawe
帔	lbdhe
帕	lbha
幡	lbhdw
帙	lbhqo
帆	lbhui
黼	lbijb
黻	lbike
幞	lbllo
幅	lbmrw
帷	lbog
帐	lbpo
帱	lbqki
帻	lbqmo
帏	lbqs
帜	lbrc
幄	lbsmg
盅	lbt
帼	lbwmg
帧	lbybo
帖	lbyr
幢	lbytg
幛	lbytj
鹇	ldpsm
隶	le
肾	leb
贤	lebo
版	lee
坚	leg
紧	levif
竖	leyt
蜴	liaph
蝎	liapv
螟	libac
蜩	libgr
览	liblu
蛆	libm
蜉	libnd
监	libt
蠼	libue
鉴	lic
蚣	lici
蜕	licru
蝉	licwj
蜥	lidhl
蛏	lieg
蛸	lifb
螳	lifbg
蝼	lifdv
蜷	lifqu
蚺	ligb
蛙	ligg
蟛	ligth
蝗	lihag
蝌	lihdj
蜊	lihdn
蟋	lihdp
蟠	lihdw
蜂	lihej
蜱	lihhj
蛛	lihjd
蛞	lihjr
蛾	lihqi
蚝	lihqu
蚱	lihs
虮	lihu
螅	lihup
螋	lihxe
蛑	liihq
螂	liiil
蚁	liik
螗	liilr
蜮	liirm
蝙	liisb
蠊	liitc
蝻	lijbj
蟪	lijip
蜿	lijnu
蛇	lijp
蛲	lijpu
蛄	lijr
蝴	lijrb
蝰	likgg
蛱	likt
蛳	lillb
蚰	lilw
虹	lim
蠕	limbb
螈	limhf
蛭	limig
蛎	limms
蚵	limnr
蝠	limrw
蚜	limvh
螵	limwf
虾	limy
蟓	linao
蟾	lincr
蜢	lindt
蛹	linib
蜓	linkg
蜒	linkm
蚓	linl
蝮	lioae
蚋	liob
蛉	lioii
蜘	liokr
蚧	lioll
蚯	liom
蜍	liomd
蝓	liomn
蛤	liomr
虼	lionu
蚍	lipp
蝶	liptd
蚌	liqj
蝽	liqka
螓	liqkd
蜻	liqmb
蚨	liqo
蝇	lirlu
蜈	lirmk
蜗	lirob
蚂	lissm
蜡	lita
蟆	litak
蝾	litbd
蠓	litbo
蝤	litcw
蜣	litgu
蟒	litit
螨	litlb
蟥	litlc
蚶	litm
蜞	litmc
蠖	litoe
蛘	litq
蟮	littr
蛐	litw
螬	litwa
蠛	litwi
廖	liu
虬	zzzz
蚴	livis
蜾	liwd
蝈	liwmg
蛔	liwr
螺	liwvf
螃	liybs
蛟	liyck
蛀	liyg
蚪	liyj
蚊	liyk
蛴	liykl
蝣	liysd
蟑	liytj
螭	liyub
虻	liyv
蟀	liyyj
史	lk
串	ll
版	llhe
牌	llhhj
牖	llisb
牍	lljnk
川	lll
帅	lllb
顺	lllo
师	llmb
片	llml
弗	lln
畅	llnsh
临	lloa
患	llp
牒	llptd
归	llsm
业	llt
黹	lltb
凿	lltu
贵	lmbo
虫	lmi
韭	lmmm
北	lmp
邶	lmpnl
芈	lmyq
非	lmyyy
费	lnbo
艴	lnnau
鼗	logte
忠	lp
背	lpb
冀	lpwtc
聿	lq
门	ls
间	lsa
阊	lsaa
阌	lsbbe
阒	lsbuk
阅	lscru
阐	lscwj
闲	lsd
闭	lsdh
阑	lsdw
阔	lsehr
闺	lsgg
阖	lsgit
阁	lsher
阍	lshpa
阋	lshxu
阆	lsiav
闼	lsiok
阈	lsirm
阗	lsjbc
闳	lski
阉	lsklu
闽	lslmi
闩	lsm
闰	lsmg
闫	lsmmm
阎	lsnhx
阚	lsnjk
阕	lsnok
阄	lsnwu
闪	lso
阀	lsoi
闷	lsp
闱	lsqs
问	lsr
闾	lsrr
闻	lssj
闯	lsssm
阙	lstuo
阃	lswd
闸	lswl
闶	lsyhu
闵	lsyk
闹	lsylb
阏	lsysy
阂	lsyvo
邺	ltnl
儿	lu
鸩	lupsm
胤	lvbu
由	lw
胄	lwb
申	lwl
邮	lwnl
曳	lwp
电	lwu
肃	lx
辈	lykq
蜚	lylmi
悲	lyp
翡	lysyy
兆	lyuo
裴	lyyhv
斐	lyyk
一	m
戬	mai
厩	maiu
亘	mam
碧	mamhr
厚	mand
霾	mbbhg
霜	mbdbu
霖	mbdd
耐	mbdi
霪	mbebg
霈	mbejb
霄	mbfb
雾	mbhes
霓	mbhxu
丽	mbib
霭	mbiuv
融	mblmi
霏	mblmy
颥	mbmbo
需	mbmhb
雳	mbmks
雩	mbmms
震	mbmmv
霆	mbnkg
邴	mbnl
页	mbo
霍	mbog
零	mboii
厕	mbon
霉	mbowy
恧	mbp
雹	mbpru
鹂	mbpsm
露	mbrmr
霞	mbrye
雪	mbsm
霹	mbsrj
翮	mbsyy
霰	mbtbk
霸	mbtjb
耍	mbv
雷	mbw
雯	mbyk
霁	mbykl
霎	mbytv
西	mcw
酉	mcwm
于	md
盂	mdbt
厢	mdbu
五	mdm
汞	me
亟	mem
不	mf
甭	mfbq
飘	mfhuk
瓢	mfhuo
平	mfj
剽	mfln
丕	mfm
歪	mfmym
鄢	mfnl
愿	mfp
否	mfr
孬	mfvnd
王	mg
瑁	mgabu
琨	mgapp
琶	mgau
再	mgb
瑷	mgbbe
珊	mgbbm
琛	mgbcd
珲	mgbkq
现	mgblu
瑗	mgbme
瑶	mgbou
璎	mgbov
玢	mgcsh
琳	mgdd
玻	mgdhe
琐	mgfbo
琰	mgff
珐	mggi
珀	mgha
珞	mgher
瑰	mghi
珠	mghjd
珩	mghon
玑	mghu
瓒	mghuo
璁	mghwp
玉	mgi
琅	mgiav
球	mgije
珑	mgikp
班	mgilg
瑭	mgilr
琏	mgioq
琮	mgjmf
琬	mgjnu
瑚	mgjrb
琦	mgkmr
珈	mgksr
璞	mgllo
到	mgln
珧	mglyo
顼	mgmbo
环	mgmf
珏	mgmgi
琊	mgmhl
玩	mgmmu
玎	mgmn
珂	mgmnr
琢	mgmpo
甄	mgmuu
鄄	mgnl
玖	mgno
珍	mgohh
玲	mgoii
琴	mgoin
玳	mgoip
致	mgok
瑜	mgomn
瑟	mgph
臻	mgqkd
玮	mgqs
璐	mgrmr
珉	mgrup
瑕	mgrye
珥	mgsj
琚	mgsjr
玛	mgssm
弄	mgt
珙	mgtc
瑛	mgtkb
璜	mgtlc
瑾	mgtlm
琪	mgtmc
瑞	mgumb
璀	mguog
瑙	mgvvw
理	mgwg
璨	mgyed
琉	mgyiu
玟	mgyk
斑	mgykg
璩	mgypo
琥	mgypu
玷	mgyr
琼	mgyrf
璇	mgyso
璋	mgytj
璃	mgyub
厂	mh
百	mha
原	mhaf
而	mhbl
邪	mhnl
雅	mhog
餮	mhoiv
鸦	mhpsm
石	mhr
万	mhs
兀	mhu
巩	mhui
面	mhwl
拷	mie
至	mig
魂	mihi
厌	mik
魇	miki
厣	mikl
动	miks
餍	mikv
靥	mikw
干	mj
刊	mjln
顸	mjmbo
邗	mjnl
天	mk
蚕	mklmi
忝	mkp
厍	mkq
历	mks
无	mku
雨	mlby
丌	mll
严	mllh
亚	mllt
工	mlm
更	mlwk
二	mm
项	mmbo
示	mmf
厉	mmhs
元	mmhu
云	mmi
亓	mmll
三	mmm
辱	mmmi
唇	mmmr
辰	mmmv
亍	mmn
邳	mmnl
政	mmok
鹉	mmpsm
吾	mmr
厨	mmti
厦	mmue
鼋	mmuu
巧	mmvs
丁	mn
殂	mnbm
殍	mnbnd
殚	mncwj
烈	mnf
型	mng
殪	mngbt
歼	mnhj
殊	mnhjd
殁	mnhue
歹	mni
残	mnim
殆	mnir
殖	mnjbm
殡	mnjoc
殃	mnkb
邛	mnl
列	mnln
顶	mnmbo
殛	mnmem
殄	mnohh
殓	mnomm
殇	mnonh
死	mnp
殉	mnpa
可	mnr
殒	mnrbo
裂	mnyhv
仄	mo
丙	mob
觋	moblu
燹	mof
赝	mogo
攻	mok
劂	moln
巫	moo
两	moob
雁	moog
豕	mpho
武	mpylm
碍	mrami
碣	mrapv
硼	mrbb
碉	mrbgr
鬲	mrbl
砚	mrblu
硐	mrbmr
碴	mrdam
破	mrdhe
泵	mre
磉	mreed
磲	mresd
硝	mrfb
磷	mrfdq
砂	mrfh
硅	mrgg
砝	mrgi
磕	mrgit
硌	mrher
碑	mrhhj
砭	mrhio
斫	mrhml
砥	mrhpm
硪	mrhqi
砟	mrhs
矶	mrhu
矾	mrhui
砜	mrhuk
砾	mrhvd
硇	mrhwk
矿	mri
碱	mrihr
碜	mrikh
碥	mrisb
碹	mrjmm
碇	mrjmo
碗	mrjnu
砣	mrjp
硗	mrjpu
砗	mrkq
硖	mrkt
砩	mrlln
砷	mrlwl
硕	mrmbo
硒	mrmcw
砰	mrmfj
矸	mrmj
硬	mrmlk
砺	mrmms
磊	mrmrr
研	mrmt
硎	mrmtn
砑	mrmvh
礓	mrmwm
确	mrnbq
矽	mrni
碌	mrnme
砍	mrno
磴	mrnot
磔	mrnqd
哥	mrnr
砀	mrnsh
碓	mrog
礁	mrogf
砼	mrom
硷	mromm
砒	mrpp
砌	mrpsh
碟	mrptd
砘	mrpu
碛	mrqmo
碡	mrqmy
砖	mrqni
噩	mrrg
砸	mrslb
码	mrssm
碾	mrstv
豆	mrt
碘	mrtbc
礤	mrtbf
礞	mrtbo
礴	mrtei
砹	mrtk
磺	mrtlc
碰	mrtlt
磋	mrtqm
磁	mrtvi
硭	mrtyv
碳	mrukf
础	mruu
碲	mrybb
磅	mrybs
磙	mrycv
礅	mrydk
硫	mryiu
碎	mryoj
砧	mryr
砬	mryt
碚	mrytr
励	msks
虿	mslmi
趸	msryo
厄	msu
开	mt
晋	mta
厮	mtcl
垩	mtg
形	mthhh
豉	mtje
豌	mtjnu
刑	mtln
豇	mtm
邢	mtnl
恶	mtp
厥	mtuo
銎	muc
夏	muhe
戛	mui
蛩	mulmi
顽	mumbo
瓦	munu
恐	mup
跫	muryo
画	muw
牙	mvdh
互	mvnm
醒	mwahm
覃	mwaj
醍	mwamo
醌	mwapp
酹	mwbdi
酮	mwbmr
贾	mwbo
酚	mwcsh
栗	mwd
酎	mwdi
粟	mwfd
厘	mwg
酥	mwhd
酪	mwher
醺	mwhgf
酷	mwhgr
酰	mwhgu
覆	mwhoe
酢	mwhs
酿	mwiav
酸	mwice
酬	mwill
醣	mwilr
醚	mwiod
酵	mwjkd
酡	mwjp
酤	mwjr
醐	mwjrb
酞	mwki
醢	mwkrt
醭	mwllo
副	mwln
酾	mwmbb
酐	mwmj
酽	mwmlh
票	mwmmf
酝	mwmmi
酊	mwmn
酩	mwnir
醑	mwnob
醮	mwogf
酴	mwomd
酶	mwowy
酯	mwpa
酏	mwpd
酌	mwpi
酲	mwrmg
配	mwsu
醪	mwsyh
醋	mwta
酣	mwtm
醛	mwtog
醴	mwtwt
酗	mwuk
要	mwv
醉	mwyoj
醵	mwypo
醇	mwyrd
醅	mwytr
醯	mwyut
下	my
焉	mylf
正	mylm
忑	myp
丐	myvs
弓	n
免	nahu
象	napo
色	nau
觯	nbcwj
觖	nbdk
觫	nbdl
觥	nbfmu
堕	nbg
觚	nbhuo
奂	nbk
勇	nbks
触	nblmi
负	nbo
觞	nbonh
隳	nbop
恿	nbp
鹬	nbpsm
角	nbq
解	nbshq
斛	nbyj
小	nc
弹	ncwj
詹	ncymr
子	nd
孟	ndbt
孙	ndf
孤	ndhuo
孺	ndmbb
孜	ndok
孢	ndpru
孔	ndu
孩	ndyvo
剥	neln
丞	nem
卺	nemsu
尔	nf
粥	nfdn
玺	nfmgi
丑	ng
疆	ngmwm
柔	nhd
及	nhe
蟊	nhlii
矜	nhoin
乃	nhs
骘	nhssm
弧	nhuo
夕	ni
甬	nibq
犟	nihq
夤	nijmc
矛	ninh
多	nini
予	ninn
飧	nioiv
舛	niq
名	nir
外	niy
敢	njok
又	nk
廴	zzzz
瞀	nkbu
鍪	nkc
煞	nkf
廷	nkhg
延	nkhym
蝥	nklmi
建	nklq
憨	nkp
鹜	nkpsm
骛	nkssm
婺	nkv
引	nl
阝	zzzz
阳	nla
陧	nlag
限	nlav
隰	nlavf
阴	nlb
阻	nlbm
陂	nldhe
隙	nlfaf
陵	nlgce
陡	nlgyo
隍	nlhag
阪	nlhe
隆	nlhem
降	nlheq
陴	nlhhj
隗	nlhi
阡	nlhj
陲	nlhjm
阼	nlhs
陇	nlikp
随	nliob
隧	nlioo
院	nljmu
陀	nljp
陈	nlkd
隋	nlkmb
阵	nlkq
陕	nlkt
陋	nlmbv
陌	nlmha
阢	nlmhu
际	nlmmf
阮	nlmmu
阿	nlmnr
隔	nlmrb
陷	nlnhx
陉	nlnom
隐	nlnsp
队	nlo
附	nlodi
阶	nloll
除	nlomd
险	nlomm
陶	nlpou
陛	nlppg
陆	nlqu
陨	nlrbo
陬	nlsje
隘	nltct
阱	nltt
隅	nlwlb
隈	nlwmv
防	nlyhs
陟	nlylh
阽	nlyr
障	nlytj
陪	nlytr
陔	nlyvo
鲳	nmaa
鲥	nmadi
鲫	nmail
弼	nman
鲲	nmapp
鳎	nmasy
鳗	nmawe
鲷	nmbgr
鳐	nmbou
鳋	nmeii
鳞	nmfdq
鲮	nmgce
鲑	nmgg
鲒	nmgr
鳇	nmhag
稣	nmhd
鳅	nmhdf
鲦	nmhed
鲧	nmhvf
鲵	nmhxu
鲅	nmike
鱿	nmiku
鳙	nmilb
鲢	nmioq
鲐	nmir
鳊	nmisb
鲩	nmjmu
鳍	nmjpa
鲼	nmjto
鲔	nmkb
劲	nmks
鲣	nmleg
鲱	nmlmy
刭	nmln
鲡	nmmbb
鳕	nmmbm
颈	nmmbo
录	nmme
鲆	nmmfj
鲕	nmmhb
鲠	nmmlk
鳜	nmmto
鳔	nmmwf
鳆	nmoae
鲋	nmodi
鲶	nmoip
鲍	nmpru
鲽	nmptd
鲭	nmqmb
鳄	nmrrs
鲰	nmsje
鲟	nmsmi
危	nmsu
鳓	nmtjs
鲜	nmtq
鳝	nmttr
鳟	nmtwi
鳢	nmtwt
鲻	nmvvw
鲤	nmwg
鲴	nmwjr
鳏	nmwlf
鳃	nmwp
鲛	nmyck
鲂	nmyhs
疏	nmyiu
鲚	nmykl
鲇	nmyr
鲸	nmyrf
鲈	nmys
了	nn
弥	nnf
孑	nnm
预	nnmbo
鬻	nnmrb
豫	nnnao
孓	nno
弪	nnom
承	nnqo
欠	no
胥	nob
灸	nof
坠	nog
蛋	nolmi
癸	nomk
登	nomrt
凳	nomru
弛	npd
张	npo
桀	nqd
蟹	nqlmi
强	nrli
盈	nsbt
鼐	nsbul
争	nsd
皱	nsdhe
尕	nsf
弭	nsj
刍	nsm
孕	nsnd
邹	nsnl
雏	nsog
急	nsp
戤	nti
勐	ntks
乙	nu
馄	nuapp
馒	nuawe
眢	nubu
馁	nubv
馇	nudam
函	nue
饷	nuhbr
饭	nuhe
饪	nuhg
馏	nuhhw
饫	nuhk
虱	nuhli
饿	nuhqi
饥	nuhu
馊	nuhxe
兔	nui
饯	nuim
饴	nuir
饽	nujbd
馕	nujbv
饶	nujpu
馆	nujrr
勉	nuks
蚀	nulmi
馈	nulmo
馅	nunhx
饮	nuno
饧	nunsh
馋	nunuy
飞	nuo
饬	nuoks
饰	nuolb
馀	nuomd
饩	nuou
怨	nup
饱	nupru
鸳	nupsm
饨	nupu
馔	nuruc
饵	nusj
饲	nusmr
馍	nutak
馓	nutbk
馑	nutlm
馐	nutqm
饼	nutt
饺	nuyck
鱼	nwm
鲁	nwma
龟	nwu
卍	nx
买	nyk
弱	nyny
疋	nyo
弦	nyvi
人	o
倡	oaa
复	oahe
但	oam
偈	oapv
内	ob
倜	obgr
俱	obmc
侗	obmr
俘	obnd
肉	obo
傺	obof
侧	obon
佣	obq
佾	ocb
俗	ocor
份	ocsh
僧	ocwa
休	od
叙	ode
煲	odf
堡	odg
付	odi
体	odm
鸺	odpm
斜	odyj
仅	oe
傩	oeog
伙	of
俏	ofb
偿	ofbi
倘	ofbr
傥	ofbu
偻	ofdv
伞	ofj
劁	ofln
您	ofp
鹪	ofpsm
伴	ofq
倦	ofqu
仕	og
赁	ogbo
集	ogd
侍	ogdi
焦	ogf
佳	ogg
凭	oghu
雠	ogiug
隼	ogj
隽	ognhs
恁	ogp
鹤	ogpsm
售	ogr
僖	ogrr
入	oh
伯	oha
侬	ohbv
傻	ohce
俐	ohdn
倭	ohdv
汆	ohe
佟	ohey
籴	ohfd
任	ohg
俾	ohhj
傀	ohi
仟	ohj
侏	ohjd
侨	ohkl
低	ohpm
件	ohq
俄	ohqi
佚	ohqo
作	ohs
仉	ohu
佩	ohub
仰	ohul
倪	ohxu
伐	oi
食	oiav
傅	oibi
俊	oice
垡	oig
侔	oihq
俅	oije
伏	oik
伪	oiks
优	oiku
刽	oiln
领	oimbo
瓴	oimuu
今	oin
令	oini
郐	oinl
贪	oino
念	oinp
含	oinr
衾	oinv
俯	oioi
俟	oiok
代	oip
偏	oisb
翎	oisyy
储	oiua
什	oj
值	ojbm
倥	ojcm
伎	oje
仗	ojk
佬	ojkp
使	ojlk
伫	ojm
傧	ojoc
佗	ojp
侥	ojpu
估	ojr
做	ojrk
倌	ojrr
偾	ojto
缶	oju
矢	ok
侑	okb
僚	okcf
矮	okhdv
矫	okhkl
俺	oklu
佐	okm
倚	okmr
短	okmrt
侉	okms
矧	oknl
鳘	oknwm
雉	okog
矬	okoog
悠	okp
知	okr
仂	oks
伽	oksr
矩	okss
侠	okt
仇	oku
繁	okvif
仲	ol
介	oll
佛	olln
俳	olmy
候	olnk
修	oloh
攸	olok
们	ols
伸	olwl
俜	olws
佻	olyo
丘	om
儒	ombb
俞	ombn
愈	ombp
兵	omc
余	omd
伍	omdm
佥	omfm
全	omg
倒	omgn
乒	omh
佰	omha
乓	omi
侄	omig
舍	omjr
俨	omlh
便	omlk
剑	omln
仁	omm
佘	ommf
会	ommi
仨	ommm
佞	ommv
畲	ommw
仃	omn
邱	omnl
例	omnn
何	omnr
俩	omob
敛	omok
合	omr
龠	omrb
命	omrl
龛	omrp
拿	omrq
盒	omrt
翕	omry
卸	omsl
岳	omu
僭	omua
佤	omuu
伢	omvh
傈	omwd
僵	omwm
像	onao
觎	onblu
儋	oncr
仔	ond
你	onf
毹	onhqu
仍	onhs
俑	onib
侈	onin
健	onkq
侯	onmk
乞	onu
从	oo
俎	oobm
坐	oog
僬	oogf
伶	ooii
仵	ooj
伤	ooks
价	ooll
丛	oom
侩	oomi
俭	oomm
偷	oomn
仡	oonu
众	ooo
伦	oop
耸	oosj
伧	oosu
侮	oowy
化	op
货	opbo
他	opd
牮	ophq
华	opj
偬	opkp
倾	opmo
伥	opo
仳	opp
偕	oppa
佝	opr
岱	opu
黛	opwgf
袋	opyhv
年	oq
傣	oqke
俦	oqki
俸	oqkq
倩	oqmb
债	oqmo
传	oqni
伟	oqs
傲	oqsk
智	ora
保	ord
侃	orhu
颔	ormbo
俣	ormk
舒	ornin
鸽	orpsm
侣	orr
假	orye
促	oryo
偃	osav
榘	osd
仞	oshi
佴	osj
倨	osjr
伛	osk
侵	osme
伺	osmr
伲	osp
僻	osrj
仓	osu
倔	osuu
借	ota
供	otc
偌	otkr
舞	otniq
儆	otpk
佯	otq
仙	ou
氲	ouabt
氛	oucsh
缺	oudk
氮	ouff
氡	ouhey
戗	oui
似	ouio
氪	oujru
氨	oujv
氕	oul
氘	oull
氚	oulll
氟	oulln
创	ouln
缸	oum
氩	oumlt
氖	ounhs
氯	ounme
氢	ounom
催	ouog
氰	ouqmb
氧	outq
罐	outrg
氙	ouu
氤	ouwk
罅	ouypd
氦	ouyvo
佃	ow
倮	owd
俚	owg
偶	owlb
儇	owlv
偎	owmv
儡	owww
每	owyi
仆	oy
倬	oyaj
侦	oybo
傍	oybs
佼	oyck
僦	oyfu
住	oyg
仿	oyhs
伉	oyhu
依	oyhv
侪	oykl
企	oylm
信	oymr
佧	oymy
歙	oyno
敏	oyok
停	oyrn
位	oyt
僮	oytg
倍	oytr
禽	oyub
毓	oyyiu
心	p
旬	pa
愠	pabt
惺	pahm
慨	paiu
怛	pam
悍	pamj
郇	panl
惕	paph
恨	pav
慢	pawe
憬	payf
惆	pbgr
恽	pbkq
惧	pbmc
恫	pbmr
恻	pbon
惘	pbtv
忪	pci
悌	pcnh
悦	pcru
憎	pcwa
惮	pcwj
也	pd
憷	pddo
忖	pdi
快	pdk
悚	pdl
懒	pdlo
颖	pdmbo
怪	peg
颍	pembo
怿	peq
悄	pfb
惝	pfbr
恍	pfmu
恃	pgdi
怯	pgi
悻	pgtj
必	ph
怕	pha
惶	phag
懊	phbk
恤	phbt
悸	phdd
愀	phdf
恪	pher
勿	phh
愧	phi
忏	phj
恬	phjr
刎	phln
忻	phml
忽	php
性	phqm
怍	phs
勺	pi
悛	pice
怵	pid
匍	pijb
惨	pikh
忧	piku
慵	pilb
慷	pile
怡	pir
憾	pirp
惦	piyr
慎	pjbc
悖	pjbd
忮	pje
惋	pjnu
鸨	pjpsm
怙	pjr
愤	pjto
怏	pkb
恢	pkf
匆	pkk
怖	pklb
肄	pklq
惰	pkmb
疑	pknio
惭	pkql
忡	pl
忱	plbu
悭	pleg
怫	plln
愦	plmo
悱	plmy
悯	plsk
恒	pmam
懦	pmbb
顷	pmbo
怀	pmf
怦	pmfj
恹	pmik
恸	pmis
鸵	pmjp
怃	pmku
悟	pmmr
邬	pmnl
匐	pmrw
鹱	pmtoe
怔	pmym
乜	pn
懈	pnbq
忸	png
忆	pnu
长	po
愎	poae
惟	pog
憔	pogf
怜	poii
忤	poj
愉	pomn
恰	pomr
怆	posu
忾	pou
悔	powy
比	pp
恂	ppa
皆	ppha
惚	pphp
毕	ppj
毙	ppmnp
怅	ppo
毖	ppph
情	pqmb
愫	pqmf
句	pr
悒	prau
劬	prks
够	prnin
鸲	prpsm
愕	prrs
包	pru
枭	psd
切	psh
怊	pshr
凫	pshu
慑	psje
怄	psk
惬	pskt
鸟	psm
怩	psp
岛	psu
袅	psyhv
世	pt
惜	pta
贳	ptbo
懂	pthg
懵	ptwu
慊	ptxc
慌	ptyu
屯	pu
匈	puk
刨	puln
惴	pumb
顿	pumbo
恺	pusu
甸	pw
悃	pwd
悝	pwg
惯	pwjo
愣	pwls
匀	py
悼	pyaj
訇	pymr
悴	pyoj
惊	pyrf
憧	pytg
恼	pyuk
忙	pyv
懔	pywf
忭	pyy
手	q
捏	qag
担	qam
捍	qamj
提	qamo
揭	qapv
撮	qase
把	qau
授	qbbe
靓	qbblu
探	qbcd
捋	qbdi
靛	qbjmo
挥	qbkq
援	qbme
静	qbnsd
摇	qbou
撄	qbov
拥	qbq
攫	qbue
扒	qc
掰	qchq
揿	qcno
扮	qcsh
掸	qcwj
耒	qd
揸	qdam
耙	qdau
耥	qdfbr
耧	qdfdv
耖	qdfh
披	qdhe
耗	qdhqu
耱	qdidr
抹	qdj
抉	qdk
耘	qdmmi
耔	qdnd
耠	qdomr
耜	qdrlr
耢	qdtbs
耕	qdtt
耩	qdttb
耦	qdwlb
耪	qdybs
搡	qeed
掇	qeee
搔	qeii
摊	qeog
择	qeq
捎	qfb
撇	qfbk
撑	qfbq
搅	qfbu
搂	qfdv
抄	qfh
拌	qfq
挡	qfsm
擞	qfvk
持	qgdi
挂	qgg
拮	qgr
撷	qgro
拍	qha
攥	qhbf
揪	qhdf
播	qhdw
扳	qhe
捭	qhhj
扦	qhj
捶	qhjm
括	qhjr
插	qhjx
契	qhk
挢	qhkl
掭	qhkp
掀	qhlo
折	qhml
拆	qhmy
托	qhp
抵	qhpm
挈	qhq
投	qhue
抑	qhul
攒	qhuo
擤	qhut
撬	qhuu
搜	qhxe
搬	qhye
搋	qhyu
找	qi
搏	qibi
贽	qibo
热	qif
垫	qig
捕	qijb
拔	qike
掺	qikh
拢	qikp
势	qiks
扰	qiku
蛰	qilmi
搪	qilr
挝	qioi
挨	qiok
拭	qipm
鸷	qipsm
挚	qiq
抬	qir
撼	qirp
护	qis
掮	qisb
捩	qisk
拚	qit
摭	qitf
拨	qive
絷	qivif
掂	qiyr
丰	qj
擦	qjbf
攮	qjbv
撺	qjcl
控	qjcm
挖	qjcu
技	qje
擀	qjjj
拷	qjks
捷	qjlo
砉	qjmhr
揎	qjmm
拧	qjmn
艳	qjnau
邦	qjnl
摈	qjoc
挠	qjpu
彗	qjsm
慧	qjsmp
按	qjv
春	qka
蠢	qkali
赘	qkbo
鏊	qkc
撩	qkcf
寿	qkdi
焘	qkdif
泰	qke
熬	qkf
秦	qkhd
奏	qkhk
舂	qkhx
獒	qkik
螯	qklmi
掩	qklu
捺	qkmf
掎	qkmr
挎	qkms
鳌	qknwm
奉	qkq
聱	qksj
骜	qkssm
挟	qkt
执	qkui
抛	qkus
拣	qkvd
揽	qliu
帮	qllb
蜇	qllmi
拂	qlln
排	qlmy
哲	qlr
踅	qlryo
扪	qls
搁	qlsr
抽	qlw
抻	qlwl
拽	qlwp
誓	qlymr
挑	qlyo
扛	qm
青	qmb
攉	qmbg
责	qmbo
擂	qmbw
抨	qmfj
捱	qmgg
拓	qmhr
表	qmhv
抚	qmku
捂	qmmr
振	qmmv
打	qmn
麦	qmni
扼	qmsu
撅	qmto
素	qmvif
毒	qmwyi
挽	qnau
换	qnbk
拯	qnem
扭	qng
揉	qnhd
扔	qnhs
掐	qnhx
专	qni
捅	qnib
抒	qnin
撖	qnjk
挺	qnkg
揆	qnok
麸	qnqo
挣	qnsd
扬	qnsh
搀	qnuy
撸	qnwa
搦	qnyy
夫	qo
替	qoa
规	qoblu
拊	qodi
推	qog
携	qogs
拎	qoii
捻	qoip
辇	qokq
拴	qomg
捡	qomm
揄	qomn
拾	qomr
挫	qoog
抡	qop
拖	qopd
搿	qorq
抢	qosu
擒	qoyb
指	qpa
掬	qpfd
掏	qpou
批	qpp
揩	qppa
拘	qpr
抱	qpru
捣	qpsu
揲	qptd
揍	qqkk
捧	qqkq
抟	qqni
扶	qqo
撵	qqoq
扣	qr
挹	qrau
捐	qrb
损	qrbo
拐	qrks
操	qrrd
揖	qrsj
捌	qrsn
撰	qruc
抿	qrup
捉	qryo
韦	qs
韫	qsabt
揠	qsav
韬	qsbhx
招	qshr
摄	qsje
揶	qsjl
据	qsjr
抠	qsk
捃	qskr
报	qsle
扫	qsm
握	qsmg
敖	qsok
挪	qsql
擗	qsrj
拒	qss
韧	qsshi
摒	qstt
搌	qstv
掘	qsuu
摺	qsya
擢	qsyg
措	qta
摸	qtak
撒	qtbk
捞	qtbs
拱	qtc
撕	qtcl
掷	qtkl
拦	qtmm
搽	qtod
搭	qtor
搓	qtqm
拼	qtt
搠	qtub
描	qtw
撙	qtwi
搛	qtxc
扎	qu
拟	quio
揣	qumb
摧	quog
拙	quu
拗	qvis
掾	qvno
拶	qvvn
纛	qwbff
捆	qwd
撂	qwhr
掼	qwjo
摁	qwkp
押	qwl
摆	qwli
擐	qwlv
掴	qwmg
摞	qwvf
拇	qwyi
扑	qy
掉	qyaj
撤	qybk
摘	qycb
拄	qyg
抗	qyhu
抖	qyj
挤	qykl
扯	qylm
掖	qyok
摅	qypp
掳	qyps
拈	qyr
搞	qyrb
掠	qyrf
攘	qyrv
拉	qyt
揞	qyta
撞	qytg
掊	qytr
接	qytv
搐	qyvw
擅	qywm
摔	qyyj
口	r
唱	raa
唧	rail
喝	rapv
嘬	rase
吧	rau
哏	rav
嗳	rbbe
啁	rbgr
剐	rbln
咀	rbm
员	rbo
嘤	rbov
鹃	rbpsm
嗣	rbsmr
嚼	rbwi
只	rc
嗡	rciy
嗲	rckn
吖	rcl
吩	rcsh
噌	rcwa
呆	rd
喳	rdam
啉	rdd
噤	rddf
喇	rdln
嗽	rdlo
叹	re
啵	rede
嗓	reed
啜	reee
嗨	reoy
哨	rfb
唢	rfbo
咪	rfd
喽	rfdv
啖	rff
吵	rfh
咣	rfmu
吐	rg
噎	rgbt
哇	rgg
嗑	rgit
哧	rglc
郢	rgnl
咭	rgr
嘻	rgrr
嘭	rgth
嗥	rhaj
唣	rhap
噢	rhbk
响	rhbr
咱	rhbu
哝	rhbv
啾	rhdf
咯	rher
咚	rhey
呼	rhfd
啤	rhhj
哌	rhhv
唾	rhjm
听	rhml
噬	rhmo
吒	rhp
哦	rhqi
咋	rhs
兄	rhu
哚	rhud
嗅	rhuk
呱	rhuo
嗖	rhxe
唆	rice
嘛	ridd
嘁	rihf
哞	rihq
喊	rihr
吮	rihu
啷	riil
哺	rijb
吠	rik
咙	rikp
咏	rine
嗵	riob
唉	riok
唳	risk
叶	rj
嘟	rjal
嗔	rjbc
嗦	rjbf
喃	rjbj
嚏	rjbo
囔	rjbv
味	rjd
吱	rje
咤	rjhp
喀	rjhr
戢	rji
嘲	rjjb
哮	rjkd
喧	rjmm
咛	rjmn
啶	rjmo
嗜	rjpa
哓	rjpu
咕	rjr
噻	rjtg
喷	rjto
嘹	rkcf
咴	rkf
喹	rkgg
呔	rki
唏	rkkb
咦	rkn
愍	rkp
啭	rkqi
另	rks
咖	rksr
吊	rlb
噗	rllo
虽	rlmi
啡	rlmy
呻	rlwl
黾	rlwu
啸	rlx
踢	rmaph
蹋	rmasy
跟	rmav
嚅	rmbb
跚	rmbbm
踩	rmbd
嚯	rmbg
蹈	rmbhx
蹊	rmbvk
趴	rmc
哂	rmcw
蹭	rmcwa
吁	rmd
跛	rmdhe
踏	rmea
躞	rmffe
呸	rmfm
呈	rmg
跬	rmgg
蹯	rmhdw
路	rmher
跣	rmhgu
踵	rmhjg
踬	rmhjo
跃	rmhk
踽	rmhlb
跌	rmhqo
跺	rmhud
躜	rmhuo
跞	rmhvd
踉	rmiav
跋	rmike
践	rmim
跹	rmioj
跆	rmir
蹁	rmisb
踱	rmite
躔	rmiwg
踮	rmiyr
蹿	rmjcl
踪	rmjmf
跎	rmjp
跷	rmjpu
吴	rmk
跨	rmkms
呖	rmks
跏	rmksr
呒	rmku
哽	rmlk
蹼	rmllo
哑	rmlt
跳	rmlyo
跖	rmmhr
蹰	rmmmi
唔	rmmr
趼	rmmt
蹶	rmmto
叮	rmn
蹂	rmnhd
趿	rmnhe
踊	rmnib
踺	rmnkq
跪	rmnmu
咧	rmnn
蹬	rmnot
呵	rmnr
跗	rmodi
踟	rmokr
跄	rmosu
趵	rmpi
啄	rmpo
跸	rmppj
跑	rmpru
蹀	rmptd
踌	rmqki
趺	rmqo
嗝	rmrb
躁	rmrrd
蹑	rmsje
踞	rmsjr
距	rmss
呃	rmsu
跽	rmsup
躇	rmtja
踯	rmtkl
躏	rmtlg
噘	rmto
蹒	rmtob
蹉	rmtqm
蹲	rmtwi
蹦	rmubb
嗄	rmue
嘎	rmui
踹	rmumb
呀	rmvh
号	rmvs
躐	rmvvu
踝	rmwd
嘌	rmwf
喱	rmwg
躅	rmwli
吓	rmy
踔	rmyaj
蹄	rmybb
跤	rmyck
蹴	rmyfu
跻	rmykl
趾	rmylm
踣	rmytr
唤	rnbk
吼	rndu
吸	rnhe
哆	rnin
吲	rnl
啊	rnlr
吹	rno
噔	rnot
噜	rnwa
呐	rob
咻	rod
咐	rodi
唯	rog
噍	rogf
呤	roii
吟	roin
勋	roks
哙	romi
喻	romn
哈	romr
喉	ronk
郧	ronl
吃	ronu
唑	roog
哗	ropj
咿	rosk
呛	rosu
噙	royb
叱	rp
吻	rphh
唿	rphp
啕	rpou
吡	rpp
喈	rppa
哔	rppj
咆	rpru
鸣	rpsm
喋	rptd
吨	rpu
啪	rqha
哳	rqhl
嗪	rqkd
唛	rqke
唪	rqkq
嗉	rqmf
啧	rqmo
呋	rqo
嗷	rqsk
啦	rqyt
吕	rr
咒	rrhu
哭	rrik
器	rrikr
嚣	rrmbr
鹭	rrpsm
品	rrr
噪	rrrd
骂	rrssm
鼍	rrwmu
唰	rsbn
叨	rsh
嘱	rshb
嗫	rsje
呕	rsk
叩	rsl
咂	rslb
别	rsln
叼	rsm
颚	rsmbo
喔	rsmg
鄂	rsnl
呢	rsp
鹗	rspsm
哪	rsql
噼	rsrj
吗	rssm
噶	rtav
唠	rtbs
哄	rtc
嘶	rtcl
嗌	rtct
嘞	rtjs
哎	rtk
喏	rtkr
呓	rtnu
嗒	rtor
咩	rtq
嗟	rtqm
嗍	rtub
喵	rtw
嘈	rtwa
嚆	rtyb
巳	ru
嘣	rubb
导	rudi
喘	rumb
嗤	rumi
哕	runi
饕	ruoiv
民	rup
异	rut
巽	rutc
咄	ruu
呶	rve
吆	rvi
呦	rvis
叫	rvl
哟	rvmi
喙	rvno
咝	rvvm
喟	rwb
哩	rwg
嘿	rwgf
咽	rwk
嗯	rwkp
呷	rwl
喁	rwlb
喂	rwmv
鄙	rwnl
呜	rxpm
卟	ry
啼	rybb
嘀	rycb
咬	ryck
吭	ryhu
唷	ryib
哜	rykl
啃	rymb
呲	rymp
唁	rymr
啮	rymu
咔	rymy
足	ryo
啐	ryoj
嘴	rypb
噱	rypo
嘘	rypt
唬	rypu
哼	ryrn
嚎	ryro
嚷	ryrv
嗾	rysk
喑	ryta
噫	rytp
唼	rytv
咳	ryvo
尸	s
刷	sbln
匹	sc
殿	schue
尿	se
臀	seb
颞	sembo
鄹	senl
聚	sepho
翳	sesyy
娶	sev
屑	sfb
屎	sfd
尉	sfdi
屡	sfdv
戳	sgi
刀	sh
鬈	shfqu
髯	shgb
髻	shgr
鬏	shhdf
髦	shhqu
刃	shi
鬃	shjmf
鬓	shjoc
属	shlb
髡	shmhu
匠	shml
髹	shod
履	shoe
屣	shoo
屦	shov
鹨	shpsm
尾	shqu
召	shr
髫	shshr
鬣	shvvu
鬟	shwlv
髭	shymp
熨	sif
髟	sihhh
肆	silq
忍	sip
匾	sisb
耳	sj
臂	sjb
鐾	sjc
聪	sjcrp
檗	sjd
取	sje
聂	sjee
耿	sjf
壁	sjg
聃	sjgb
聊	sjhhl
聒	sjhjr
聍	sjjmn
屠	sjka
耽	sjlbu
聩	sjlmo
聘	sjlws
璧	sjmgi
耵	sjmn
甓	sjmuu
耶	sjnl
聆	sjoii
擘	sjq
居	sjr
职	sjrc
劈	sjsh
联	sjtk
嬖	sjv
襞	sjyhv
耻	sjylm
譬	sjymr
区	sk
殴	skhue
瓯	skmuu
欧	skno
鸥	skpsm
匦	skqu
君	skr
尻	sku
卩	sl
匝	slb
卫	slm
颐	slmbo
匮	slmo
匪	slmy
赜	slqmo
臣	slsl
届	slw
卧	sly
帚	smblb
驵	smbm
寻	smdi
驭	sme
骚	smeii
驿	smeq
灵	smf
匡	smg
骆	smher
骝	smhhw
骄	smhkl
骢	smhwp
骏	smice
屋	smig
骖	smikh
骀	smir
驴	smis
骗	smisb
骟	smisy
驼	smjp
骁	smjpu
驮	smk
驳	smkk
骑	smkmr
驶	smlk
驯	smlll
骥	smlpc
骋	smlws
骊	smmbb
层	smmi
骠	smmwf
驺	smnsm
驸	smodi
骓	smog
验	smomm
骅	smopj
驰	smpd
驹	smpr
司	smr
骤	smseo
驱	smsk
骣	smsnd
骐	smtmc
骈	smtt
驷	smwc
骒	smwd
骡	smwvf
驻	smyg
骧	smyrv
骇	smyvo
孱	sndd
屙	snlr
尺	so
昼	soam
医	sok
咫	sorc
尽	soy
尼	sp
屁	spp
屉	spt
那	sqnl
叵	sr
劭	srks
剧	srln
邵	srnl
慝	srp
群	srtq
辟	srytj
巨	ss
马	ssm
局	ssr
凹	ssu
匿	stkr
羼	stqq
屏	stt
展	stv
己	su
熙	suf
兕	suhu
改	suok
忌	sup
屈	suu
郾	svnl
匣	swl
习	sy
翟	syog
羽	sysy
羿	syt
翼	sywtc
翠	syyoj
犀	syyq
翌	syyt
廿	t
昔	ta
菖	taa
萌	tab
莳	tadi
草	taj
莫	tak
暮	taka
幕	takb
墓	takg
蓦	takm
慕	takp
摹	takq
募	taks
鹊	tapsm
葛	tapv
蕞	tase
芭	tau
茛	tav
蔓	tawe
觏	tbblu
典	tbc
荣	tbd
荥	tbe
荧	tbf
藤	tbfe
塑	tbg
荦	tbhq
藐	tbhu
荤	tbkq
劳	tbks
萤	tbli
前	tbln
苋	tblu
苴	tbm
颟	tbmbo
莹	tbmg
蒙	tbmo
茼	tbmr
莩	tbnd
煎	tbnf
剪	tbnh
茕	tbnu
翦	tbny
蔡	tbof
散	tbok
莺	tbpm
苘	tbr
营	tbrr
菔	tbse
苜	tbu
荽	tbv
萦	tbvf
共	tc
期	tcb
益	tcbt
基	tcg
夔	tche
斯	tchml
蓊	tciy
蕲	tcjl
欺	tcno
恭	tcp
鹣	tcpsm
巷	tcru
芬	tcsh
綦	tcvif
酋	tcwm
葙	tdbu
菘	tdci
菥	tdhl
茉	tdj
蔌	tdlo
苯	tdm
莱	tdt
菹	tebm
菠	tede
莎	tefh
落	tehr
蒎	tehv
藩	tehw
蒲	teib
薄	teii
蒗	teiv
劐	teln
茳	tem
萍	temj
菏	temr
荡	tenh
藻	terd
蕖	tesd
范	tesu
茫	teyv
蔽	tfbk
蒌	tfdv
薮	tfvk
芏	tg
苒	tgb
盖	tgbt
菱	tgce
蔷	tgcw
羔	tgf
羹	tgftk
葑	tggi
羲	tghds
羌	tghu
美	tgk
颧	tgmbo
莰	tgno
恙	tgp
鹳	tgpsm
薹	tgrg
姜	tgv
羡	tgyno
葩	thau
首	thbu
莉	thdn
莠	thds
萎	thdv
蕃	thdw
薰	thgf
藜	thhe
萆	thhj
茆	thhl
芊	thj
茱	thjd
董	thjg
荞	thkl
芹	thml
薇	thok
荇	thon
茚	thpl
莪	thqi
薛	thrj
芟	thue
芪	thup
蔸	thvu
蓖	thwp
萸	thxo
莨	tiav
蘑	tidr
蘼	tidy
茂	tih
蒇	tiho
藏	tihs
葳	tihv
莆	tijb
茇	tike
茏	tikp
莽	tikt
芝	tino
蓬	tioj
蘧	tioo
莲	tioq
鹚	tipsm
苔	tir
芦	tis
蔗	titf
蔼	tiuv
蒺	tiyk
卅	tj
靼	tjam
靶	tjau
芾	tjb
荸	tjbd
带	tjblb
蓉	tjcr
芰	tje
鞘	tjfb
鞋	tjgg
鞒	tjhkl
靳	tjhml
鞑	tjiok
蕙	tjip
鞍	tjjv
著	tjka
鞅	tjkb
勒	tjks
萋	tjlv
苎	tjm
蔻	tjme
萱	tjmm
菪	tjmr
莞	tjmu
鞔	tjnau
鞣	tjnhd
菀	tjnu
蓿	tjoa
鞭	tjomk
靴	tjop
蓍	tjpa
鞠	tjpfd
荛	tjpu
鞫	tjpyr
苦	tjr
葫	tjrb
菅	tjrr
冁	tjstv
鞴	tjthb
鞯	tjtkd
鞲	tjttb
关	tk
英	tkb
檠	tkd
荻	tkhf
获	tkhk
莸	tkhu
荐	tkld
茬	tklg
萘	tkmf
荑	tkn
郑	tknl
擎	tkq
若	tkr
惹	tkrp
苏	tksc
茄	tksr
荔	tkss
荚	tkt
艽	tku
芄	tkui
警	tkymr
萜	tlbr
蓝	tlit
革	tlj
茧	tlmi
蒉	tlmo
菲	tlmy
燕	tlpf
堇	tlqm
蔺	tlsg
黄	tlwc
萧	tlx
甘	tm
薷	tmbb
藿	tmbg
觐	tmblu
蕾	tmbw
茜	tmcw
某	tmd
蒜	tmff
苹	tmfj
苤	tmfm
蘸	tmgf
勤	tmks
芜	tmku
兰	tmm
其	tmmc
芸	tmmi
芫	tmmu
甚	tmmv
鄞	tmnl
薤	tmnm
苛	tmnr
蕤	tmom
葬	tmpt
苊	tmsu
蕨	tmto
芽	tmvh
蕈	tmwj
蔫	tmyf
芎	tn
荪	tndf
菰	tndo
芤	tndu
蒸	tnef
芨	tnhe
艹	tnhs
艿	zzzz
萏	tnhx
茅	tnih
茗	tnir
苑	tniu
莛	tnkg
荫	tnlb
萨	tnlh
蓟	tnmn
藓	tnmq
蔬	tnmu
蓣	tnno
芡	tno
葵	tnok
茎	tnom
艺	tnu
菡	tnue
菟	tnui
荬	tnyk
芮	tob
茶	tod
苻	todi
萑	tog
蕉	togf
荏	tohg
苓	toii
茯	toik
芩	toin
蘩	tokf
莜	tolk
芥	toll
荼	tomd
荃	tomg
荟	tomi
蔹	tomk
莶	tomm
荷	tomr
苁	too
花	top
葆	tord
苍	tosu
莓	towy
蓓	toyr
莅	toyt
芯	tp
荀	tpa
菊	tpfd
芴	tphh
芍	tpi
葡	tpib
葱	tpkp
苌	tpo
萄	tpou
芘	tpp
蒈	tppa
荜	tppj
蕊	tppp
苟	tpr
苞	tpru
茑	tpsm
羊	tq
羯	tqapv
着	tqbu
藉	tqda
藕	tqdb
葜	tqhk
羝	tqhpm
羧	tqice
菝	tqie
蓁	tqkd
差	tqm
菁	tqmb
羞	tqng
羟	tqnom
芙	tqo
羚	tqoii
苇	tqs
翔	tqsyy
羰	tqukf
蕺	trji
鄯	trnl
莴	trob
敬	trok
莒	trr
萼	trrs
葺	trsj
苠	trup
葭	trye
蔚	tsfi
苕	tshr
蕻	tsic
茸	tsj
节	tsl
荨	tsmi
荩	tsoy
薜	tsrj
苣	tss
芑	tsu
蓼	tsyh
井	tt
普	tta
荆	ttln
苷	ttm
萁	ttmc
瓶	ttmuu
葚	ttmv
善	ttr
蒴	ttub
蠲	ttwli
蒹	ttxc
朔	tub
苡	tuio
馘	tuirm
茁	tuu
戡	tvi
孳	tvid
兹	tvii
慈	tvip
菇	tvjr
勘	tvks
药	tvmi
荭	tvmm
蕴	tvmt
莼	tvmu
茹	tvr
芗	tvvh
斟	tvyj
苗	tw
曹	twa
瞢	twbbu
薨	twbmp
甍	twbmu
尊	twdi
菌	twhd
蔑	twihi
猷	twik
奠	twk
蒽	twkp
薯	twla
萝	twni
葸	twp
鹋	twpsm
茴	twr
兼	txc
蒂	tybb
蒡	tybs
茭	tyck
薪	tydl
菽	tyfe
芳	tyhs
茺	tyiu
荠	tykl
蒋	tyli
芷	tylm
茈	tymp
茨	tyno
萃	tyoj
苫	tyr
蒿	tyrb
藁	tyrd
葶	tyrn
蔟	tysk
菸	tysy
莘	tytj
薏	tytp
菩	tytr
蓠	tyub
芒	tyv
蕹	tyvg
荒	tyvu
蓄	tyvw
蓑	tywv
苄	tyy
山	u
嵋	uahu
岜	uau
崩	ubb
岗	ubk
岘	ublu
颛	ubmbo
峒	ubmr
峪	ucor
崧	udci
崃	udt
凼	ue
峄	ueq
峭	ufb
嵴	ufcb
嶙	ufdq
嵝	ufdv
峙	ugdi
匕	uh
嵊	uhdp
峰	uhej
峁	uhhl
嵬	uhi
峤	uhkl
峨	uhqi
岚	uhuk
巍	uhvi
峻	uice
崴	uihv
以	uio
崆	ujcm
巅	ujco
岐	uje
崇	ujmf
岵	ujr
凶	uk
岽	ukd
炭	ukf
崤	ukkb
崦	uklu
崎	ukmr
崭	ukql
峡	ukt
岿	ulls
岫	ulw
崖	umgg
岩	umhr
蚩	umli
岸	ummj
岢	umnr
豳	umoo
岍	umt
岈	umvh
崾	umwv
岌	unhe
岁	uni
刿	unln
嶝	unot
峥	unsd
崔	uog
岭	uoii
岑	uoin
嵛	uomn
峇	uomr
屹	uonu
峋	upa
嶷	upko
岣	upr
岷	urup
岖	usk
岂	usu
崛	usuu
嵘	utbd
崂	utbs
嵌	utmo
酆	utnl
嵯	utqm
嵫	utvi
出	uu
觊	uublu
粜	uufd
凯	uuhu
剀	uuln
祟	uummf
幽	uvii
崮	uwjr
岬	uwl
崽	uwp
鬯	uxp
嵩	uyrb
崞	uyrd
屿	uysm
嶂	uytj
女	v
娼	vaa
媪	vabt
媚	vahu
妲	vam
嫒	vbbe
姗	vbbm
姐	vbm
媛	vbme
娣	vcnh
婵	vcwj
断	vdhml
嫩	vdlk
剿	vdln
奴	ve
努	veks
帑	velb
弩	ven
孥	vend
胬	veobo
怒	vep
驽	vessm
嫦	vfbb
妙	vfh
嫱	vgcw
娃	vgg
奘	vgk
嬉	vgrr
妊	vhg
婢	vhhj
戕	vhi
姝	vhjd
妖	vhk
娇	vhkl
飨	vhoiv
婚	vhpa
娥	vhqi
姓	vhqm
媳	vhup
媲	vhwp
嫂	vhxe
厶	vi
娘	viav
嬷	vidi
糸	vif
幼	viks
始	vir
妒	vis
畿	viw
嫉	viyk
妹	vjd
妓	vje
姹	vjhp
姥	vjkp
婶	vjll
婕	vjlo
嫁	vjmo
婉	vjnu
嫔	vjoc
娆	vjpu
姑	vjr
姨	vkn
凵	vl
爿	vlmh
收	vlok
娴	vlsd
妯	vlw
娉	vlws
姊	vlxh
姚	vlyo
缇	vmamo
绲	vmapp
缦	vmawe
绷	vmbb
绶	vmbbe
绸	vmbgr
纲	vmbk
组	vmbm
缓	vmbme
缨	vmbov
孀	vmbu
缈	vmbuh
绥	vmbv
绨	vmcnh
纷	vmcsh
缯	vmcwa
缃	vmdbu
纣	vmdi
缀	vmeee
绎	vmeq
绡	vmfb
绱	vmfbr
缕	vmfdv
彝	vmfft
纱	vmfh
绊	vmfq
绻	vmfqu
绫	vmgce
结	vmgr
缬	vmgro
绵	vmhab
绣	vmhds
绦	vmhed
绛	vmheq
络	vmher
终	vmhey
纤	vmhj
缎	vmhje
缍	vmhjm
绗	vmhon
缴	vmhsk
缵	vmhuo
纸	vmhup
绺	vmhyr
纩	vmi
缚	vmibi
缄	vmihr
绒	vmij
绂	vmike
线	vmim
缝	vmioj
缒	vmior
绐	vmir
编	vmisb
缠	vmiwg
奸	vmj
缜	vmjbc
绪	vmjka
综	vmjmf
绽	vmjmo
续	vmjnk
缩	vmjoa
缤	vmjoc
绕	vmjpu
绾	vmjrr
缭	vmkcf
绮	vmkmr
绔	vmkms
妩	vmku
纨	vmkui
练	vmkvd
缆	vmliu
绋	vmlln
缋	vmlmo
绯	vmlmy
娅	vmlt
绅	vmlwl
红	vmm
纡	vmmd
缅	vmmhw
绠	vmmlk
纭	vmmmi
缙	vmmta
娠	vmmv
缥	vmmwf
缰	vmmwm
绝	vmnau
纽	vmng
级	vmnhe
纾	vmnin
绿	vmnme
经	vmnom
绉	vmnsm
纳	vmob
维	vmog
绘	vmomi
缏	vmomk
给	vmomr
缑	vmonk
纥	vmonu
纵	vmoo
纶	vmop
绚	vmpa
约	vmpi
彘	vmpop
纰	vmpp
绁	vmpt
纯	vmpu
绑	vmqjl
绩	vmqmo
纬	vmqs
辔	vmr
绢	vmrb
织	vmrc
绳	vmrlu
缗	vmrpa
缲	vmrrd
缉	vmrsj
纫	vmshi
绍	vmshr
纪	vmsu
缪	vmsyh
妍	vmt
缢	vmtct
缂	vmtlj
绀	vmtm
缮	vmttr
缣	vmtxc
绌	vmuu
继	vmvfd
纠	vmvl
缘	vmvno
缫	vmvvd
缁	vmvvw
细	vmw
嫖	vmwf
缳	vmwlv
缌	vmwp
缧	vmwvf
绰	vmyaj
缔	vmybb
绞	vmyck
嫣	vmyf
纺	vmyhs
统	vmyiu
纹	vmyk
缟	vmyrb
缡	vmyub
娩	vnau
好	vnd
妞	vng
奶	vnhs
妤	vnin
婀	vnlr
彖	vnmo
婿	vnob
妗	voin
蠡	volii
她	vpd
妁	vpi
妣	vpp
婧	vqmb
婊	vqmv
如	vr
娟	vrb
娱	vrmk
娲	vrob
恕	vrp
絮	vrvif
娓	vshu
妪	vsk
姬	vsll
妇	vsm
妮	vsp
娜	vsql
妈	vssm
妃	vsu
嫫	vtak
媒	vtmd
姘	vtt
媾	vttb
嫌	vtxc
姒	vuio
媸	vumi
乡	vvh
丝	vvm
鸶	vvmpm
邕	vvrau
甾	vvw
巢	vvwd
娌	vwg
姻	vwk
嫘	vwvf
姆	vwyi
嫡	vycb
姣	vyck
妨	vyhs
婷	vyrn
嫜	vytj
嬗	vywm
田	w
胃	wb
愚	wbp
四	wc
果	wd
团	wdh
颗	wdmbo
夥	wdnin
黠	wfgr
黢	wfice
默	wfik
黪	wfikh
黩	wfjnk
黟	wfnin
黔	wfoin
畔	wfq
圈	wfqu
黜	wfuu
黝	wfvis
黥	wfyrf
黯	wfyta
里	wg
黑	wgf
墨	wgfg
畦	wgg
野	wgnin
圉	wgtj
畈	whe
略	wher
图	whey
圃	wijb
畎	wik
勿	win
毋	wj
贯	wjbo
畹	wjnu
固	wjr
因	wk
囿	wkb
畸	wkmr
恩	wkp
男	wks
甲	wl
禺	wlbi
罾	wlcwa
罢	wlgi
罴	wlgif
罚	wliun
罱	wljbj
置	wljbm
署	wljka
罟	wljr
罨	wlklu
罪	wllmy
罘	wlmf
罡	wlmym
罗	wlni
蜀	wlpli
罹	wlpog
鸭	wlpsm
羁	wltjm
罩	wlyaj
詈	wlymr
国	wmgi
畀	wmll
圄	wmmr
园	wmmu
町	wmn
畏	wmv
囝	wnd
墅	wng
囚	wo
畛	wohh
囹	woii
畋	wok
界	woll
囵	wop
思	wp
囫	wphh
毗	wpp
囤	wpu
畴	wqki
圊	wqmb
围	wqs
回	wr
圆	wrbo
嬲	wsvws
囡	wv
累	wvif
圜	wwlv
母	wyi
疃	wytg
曰	xa
晕	xabkq
旰	xamj
冕	xanau
煦	xarf
晾	xayrf
冗	xbhu
胍	xbhuo
脎	xbkd
肽	xbki
肛	xbm
冢	xbmpo
肼	xbtt
睢	xbuog
镓	xcjmo
丫	xcl
钩	xcpi
铳	xcyiu
锿	xcyrv
板	xdhe
杠	xdm
柰	xdmmf
构	xdpi
赉	xdtbo
梓	xdytj
汩	xea
沓	zzzz
漱	xedlo
双	xee
溴	xehuk
戏	xei
沭	xeid
泱	xekb
淆	xekkb
洒	xemcw
泓	xeni
淮	xeog
柒	xepd
敞	xfbok
炯	xfbr
炔	xfdk
尘	xfg
圹	xgi
嘉	xgrtr
种	xhdl
剁	xhdln
簌	xhdlo
处	xhey
么	xhi
邸	xhmnl
鸹	xhrps
臬	xhud
凤	xhue
氏	xhup
毡	xhuyr
床	xid
魔	xiddi
庋	xije
义	xik
府	xiodi
达	xiok
迸	xiott
庀	xip
邰	xirnl
怠	xirp
盛	xisbt
弁	xit
讹	xiuop
诣	xiupa
宋	xjd
蹇	xjtco
剜	xjuln
央	xkb
郁	xkbnl
杀	xkd
堑	xklg
旮	xkua
鸠	xkups
蚬	xlibl
蛊	xlibt
郦	xmbnl
贡	xmbo
鸸	xmbps
灭	xmf
压	xmgi
郅	xmgnl
玫	xmgok
琵	xmgpp
功	xmks
蜃	xmmmi
厅	xmmn
亏	xmmvs
酃	xmrnl
歌	xmrno
劢	xmsks
厝	xmta
虺	xmulm
顾	xmumb
弘	xni
鲺	xnmnu
巯	xnmyi
久	xno
氽	xoe
隹	xog
佶	xogr
仫	xohi
仪	xoik
邻	xoinl
午	xoj
攵	xok
佑	xokr
个	xol
倏	xolok
仝	xom
俪	xombb
僳	xomwd
亿	xonu
怂	xoop
仑	xop
贷	xopbo
颌	xormb
伊	xosk
气	xou
旨	xpa
勾	xpi
忉	xpsh
乌	xpsm
耨	xqdmm
抓	xqhlo
恝	xqhp
扩	xqi
挞	xqiok
击	xqu
邑	xrau
呗	xrbo
叭	xrc
叽	xrhu
哒	xriok
嚓	xrjbf
嘧	xrjpu
叻	xrks
呙	xrob
啥	xromr
吣	xrp
哐	xrsmg
嗬	xrtor
戮	xshi
屐	xshoe
慰	xsip
尹	xsk
刁	xsm
郡	xsrnl
已	xsu
蓥	xtbc
菜	xtbd
茔	xtbg
蒯	xtbln
歉	xtcno
孽	xthjd
蘅	xthon
蓰	xthoo
艾	xtk
芋	xtmd
苈	xtmks
蓐	xtmmi
邯	xtmnl
茌	xtog
养	xtoll
并	xtt
荮	xtvmi
曲	xtw
茵	xtwk
屺	xusu
幺	xvi
妫	xviks
幻	xvis
缱	xvmio
缛	xvmmm
困	xwd
灞	xxemb
憩	xxhup
庆	xxik
忒	xxipp
槊	xxtbd
蘖	xxthj
薅	xxtvm
凋	xybgr
奕	xyck
决	xydk
颜	xyhmb
头	xyk
忐	xymp
戆	xyop
觇	xyrbl
毫	xyrbu
点	xyrf
膂	xyvb
补	xyy
卜	y
桌	yad
卓	yaj
袒	yam
歆	yano
裼	yaph
褐	yapv
韵	yapy
韶	yashr
裉	yav
望	ybhg
帝	yblb
啻	yblbr
睿	ybmcu
贞	ybo
敲	ybye
旁	ybyhs
六	yc
商	ycbr
銮	ycc
栾	ycd
变	yce
兖	yciu
衮	yciv
交	yck
蛮	yclmi
弯	ycn
孪	ycnd
脔	ycobo
裕	ycor
恋	ycp
鸾	ycpsm
挛	ycq
弈	yct
峦	ycu
娈	ycv
凇	ydci
襟	yddf
襻	yddq
被	ydhe
新	ydhml
衬	ydi
袂	ydk
孰	ydkui
郭	ydnl
敦	ydok
鹑	ydpsm
冰	ye
督	yebu
裰	yeee
粲	yefd
壑	yeg
衩	yei
餐	yeoiv
褛	yfdv
叔	yfe
就	yfiku
袢	yfq
裆	yfsm
主	yg
凌	ygce
褂	yggy
装	ygyhv
广	yh
袼	yher
衽	yhg
冼	yhgu
衫	yhhh
彦	yhhhh
裨	yhhj
袄	yhk
频	yhmbo
方	yhs
亢	yhu
衣	yhv
裒	yhxv
褫	yhyu
育	yib
熟	yif
塾	yig
减	yihr
充	yihu
裤	yikq
请	yin
裢	yioq
褪	yiov
冶	yir
褊	yisb
弃	yit
斗	yj
袜	yjd
辣	yjdl
赣	yjheo
彰	yjhhh
瓣	yjhoj
辨	yjilj
辩	yjiuj
褚	yjka
凄	yjlv
鄣	yjnl
辫	yjvmj
文	yk
冻	ykd
齐	ykll
齑	yklll
刘	ykln
斓	yklsw
斋	ykmhb
斌	ykmpm
郊	yknl
效	ykok
憝	ykp
吝	ykr
紊	ykvif
冲	yl
市	ylb
壮	ylg
衷	ylhv
状	ylik
褴	ylit
剂	ylln
止	ylm
步	ylmh
亦	ylnc
将	ylnii
褙	ylpb
裥	ylsa
妆	ylv
袖	ylw
上	ym
肯	ymb
襦	ymbb
歧	ymje
颤	ymmbo
褥	ymmi
言	ymmr
冽	ymnn
欤	ymno
此	ymp
雌	ympog
齿	ymuo
冱	ymvm
卡	ymy
桨	ynd
浆	yne
袤	ynhv
襁	ynii
奖	ynk
酱	ynmcw
次	yno
净	ynsd
衲	yob
资	yobo
盗	yobt
褒	yodv
粢	yofd
准	yog
颦	yohhj
毅	yohue
冷	yoii
袱	yoik
衿	yoin
劾	yoks
刻	yoln
颏	yombo
裣	yomm
袷	yomr
瓷	yomuu
夜	yonk
卒	yooj
恣	yop
咨	yor
褓	yord
姿	yov
赀	ypbo
柴	ypd
虎	yphu
凝	ypko
虏	ypks
虚	ypllt
砦	ypmhr
些	ypmm
觜	ypnbq
虑	ypp
虞	yprmk
袍	ypru
虐	ypsm
紫	ypvif
虔	ypyk
訾	ypymr
亵	yqiv
凑	yqkk
裱	yqmv
占	yr
膏	yrbb
赢	yrbbu
蠃	yrblu
亭	yrbn
豪	yrbo
亳	yrbp
高	yrbr
羸	yrbtu
亮	yrbu
嬴	yrbvu
京	yrf
况	yrhu
哀	yrhv
战	yri
剖	yrln
裎	yrmg
瓿	yrmuu
享	yrnd
烹	yrnf
部	yrnl
亨	yrnn
襄	yrrv
乩	yru
卢	ys
初	ysh
裾	ysjr
裙	yskr
与	ysm
颅	ysmbo
邡	ysnl
旃	ysoby
旌	ysohm
旄	ysohu
旅	ysohv
旆	ysojb
放	ysok
旖	ysokr
旋	ysono
族	ysook
施	ysopd
旎	ysosp
旗	ysotc
於	ysoy
旒	ysoyu
鸬	yspsm
冯	yssm
褶	ysya
立	yt
音	yta
竟	ytahu
章	ytaj
意	ytap
竭	ytapv
觑	ytblu
亲	ytd
竦	ytdl
产	yth
飒	ythuk
竣	ytice
辛	ytj
褡	ytor
靖	ytqmb
竞	ytrhu
翊	ytsyy
端	ytumb
妾	ytv
童	ytwg
站	ytyr
龈	yuav
龃	yubm
彪	yuhhh
龋	yuhlb
离	yukb
颃	yumbo
龉	yummr
龄	yuoii
龀	yup
龅	yupru
鹫	yupsm
龊	yuryo
龆	yushr
龌	yusmg
龇	yuymp
亡	yv
肓	yvb
裔	yvbcr
盲	yvbu
壅	yvgg
饔	yvgv
雍	yvhg
亥	yvho
瓤	yvhuo
玄	yvi
畜	yviw
邙	yvnl
忘	yvp
氓	yvrup
妄	yvv
亩	yw
裸	ywd
裹	ywdv
卤	ywk
衰	ywmv
禀	ywrf
卣	yws
鹾	ywtqm
卞	yy
率	yyoj
凉	yyrf
凛	yywd
丨	zzzz
丿	zzzz
丶	zzzz
匚	zzzz
刂	zzzz
冂	zzzz
亻	zzzz
勹	zzzz
亠	zzzz
冫	zzzz
廾	zzzz
尢	zzzz
扌	zzzz
囗	zzzz
彳	zzzz
犭	zzzz
夂	zzzz
饣	zzzz
忄	zzzz
丬	zzzz
氵	zzzz
宀	zzzz
辶	zzzz
彐	zzzz
屮	zzzz
纟	zzzz
巛	zzzz
攴	zzzz
灬	zzzz
礻	zzzz
肀	zzzz
钅	zzzz
衤	zzzz
虍	zzzz
‘	za
’	za
“	za
”	za
〔	za
〕	za
〈	za
〉	za
《	za
》	za
…	za
「	za
」	za
『	za
』	za
〖	za
〗	za
【	za
】	za
№	za
☆	za
★	za
○	za
●	za
◎	za
◇	za
◆	za
□	za
■	za
△	za
▲	za
※	za
→	za
←	za
↑	za
↓	za
〓	za
ⅰ	zb
ⅱ	zb
ⅲ	zb
ⅳ	zb
ⅴ	zb
ⅵ	zb
ⅶ	zb
ⅷ	zb
ⅸ	zb
ⅹ	zb
⒈	zba
⒉	zba
⒊	zba
⒋	zba
⒌	zba
⒍	zba
⒎	zba
⒏	zba
⒐	zba
⒑	zba
⒒	zba
⒓	zba
⒔	zba
⒕	zba
⒖	zba
⒗	zba
⒘	zba
⒙	zba
⒚	zba
⒛	zba
⑴	zbb
⑵	zbb
⑶	zbb
⑷	zbb
⑸	zbb
⑹	zbb
⑺	zbb
⑻	zbb
⑼	zbb
⑽	zbb
⑾	zbb
⑿	zbb
⒀	zbb
⒁	zbb
⒂	zbb
⒃	zbb
⒄	zbb
⒅	zbb
⒆	zbb
⒇	zbb
①	zbc
②	zbc
③	zbc
④	zbc
⑤	zbc
⑥	zbc
⑦	zbc
⑧	zbc
⑨	zbc
⑩	zbc
㈠	zbd
㈡	zbd
㈢	zbd
㈣	zbd
㈤	zbd
㈥	zbd
㈦	zbd
㈧	zbd
㈨	zbd
㈩	zbd
Ⅰ	zbe
Ⅱ	zbe
Ⅲ	zbe
Ⅳ	zbe
Ⅴ	zbe
Ⅵ	zbe
Ⅶ	zbe
Ⅷ	zbe
Ⅸ	zbe
Ⅹ	zbe
Ⅺ	zbe
Ⅻ	zbe
ぁ	zc
あ	zc
ぃ	zc
い	zc
ぅ	zc
う	zc
ぇ	zc
え	zc
ぉ	zc
お	zc
か	zc
が	zc
き	zc
ぎ	zc
く	zc
ぐ	zc
け	zc
げ	zc
こ	zc
ご	zc
さ	zc
ざ	zc
し	zc
じ	zc
す	zc
ず	zc
せ	zc
ぜ	zc
そ	zc
ぞ	zc
た	zc
だ	zc
ち	zc
ぢ	zc
っ	zc
つ	zc
づ	zc
て	zc
で	zc
と	zc
ど	zc
な	zc
に	zc
ぬ	zc
ね	zc
の	zc
は	zc
ば	zc
ぱ	zc
ひ	zc
び	zc
ぴ	zc
ふ	zc
ぶ	zc
ぷ	zc
へ	zc
べ	zc
ぺ	zc
ほ	zc
ぼ	zc
ぽ	zc
ま	zc
み	zc
む	zc
め	zc
も	zc
ゃ	zc
や	zc
ゅ	zc
ゆ	zc
ょ	zc
よ	zc
ら	zc
り	zc
る	zc
れ	zc
ろ	zc
ゎ	zc
わ	zc
ゐ	zc
ゑ	zc
を	zc
ん	zc
ァ	zd
ア	zd
ィ	zd
イ	zd
ゥ	zd
ウ	zd
ェ	zd
エ	zd
ォ	zd
オ	zd
カ	zd
ガ	zd
キ	zd
ギ	zd
ク	zd
グ	zd
ケ	zd
ゲ	zd
コ	zd
ゴ	zd
サ	zd
ザ	zd
シ	zd
ジ	zd
ス	zd
ズ	zd
セ	zd
ゼ	zd
ソ	zd
ゾ	zd
タ	zd
ダ	zd
チ	zd
ヂ	zd
ッ	zd
ツ	zd
ヅ	zd
テ	zd
デ	zd
ト	zd
ド	zd
ナ	zd
ニ	zd
ヌ	zd
ネ	zd
ノ	zd
ハ	zd
バ	zd
パ	zd
ヒ	zd
ビ	zd
ピ	zd
フ	zd
ブ	zd
プ	zd
ヘ	zd
ベ	zd
ペ	zd
ホ	zd
ボ	zd
ポ	zd
マ	zd
ミ	zd
ム	zd
メ	zd
モ	zd
ャ	zd
ヤ	zd
ュ	zd
ユ	zd
ョ	zd
ヨ	zd
ラ	zd
リ	zd
ル	zd
レ	zd
ロ	zd
ヮ	zd
ワ	zd
ヰ	zd
ヱ	zd
ヲ	zd
ン	zd
ヴ	zd
ヵ	zd
ヶ	zd
Α	zf
Β	zf
Γ	zf
Δ	zf
Ε	zf
Ζ	zf
Η	zf
Θ	zf
Ι	zf
Κ	zf
Λ	zf
Μ	zf
Ν	zf
Ξ	zf
Ο	zf
Π	zf
Ρ	zf
Σ	zf
Τ	zf
Υ	zf
Φ	zf
Χ	zf
Ψ	zf
Ω	zf
α	zf
β	zf
γ	zf
δ	zf
ε	zf
ζ	zf
η	zf
θ	zf
ι	zf
κ	zf
λ	zf
μ	zf
ν	zf
ξ	zf
ο	zf
π	zf
ρ	zf
σ	zf
τ	zf
υ	zf
φ	zf
χ	zf
ψ	zf
ω	zf
︵	zf
︶	zf
︹	zf
︺	zf
︿	zf
﹀	zf
︽	zf
︾	zf
﹁	zf
﹂	zf
﹃	zf
﹄	zf
︻	zf
︼	zf
︷	zf
︸	zf
︱	zf
	zf
︳	zf
︴	zf
А	zg
Б	zg
В	zg
Г	zg
Д	zg
Е	zg
Ё	zg
Ж	zg
З	zg
И	zg
Й	zg
К	zg
Л	zg
М	zg
Н	zg
О	zg
П	zg
Р	zg
С	zg
Т	zg
У	zg
Ф	zg
Х	zg
Ц	zg
Ч	zg
Ш	zg
Щ	zg
Ъ	zg
Ы	zg
Ь	zg
Э	zg
Ю	zg
Я	zg
а	zg
б	zg
в	zg
г	zg
д	zg
е	zg
ё	zg
ж	zg
з	zg
и	zg
й	zg
к	zg
л	zg
м	zg
н	zg
о	zg
п	zg
р	zg
с	zg
т	zg
у	zg
ф	zg
х	zg
ц	zg
ч	zg
ш	zg
щ	zg
ъ	zg
ы	zg
ь	zg
э	zg
ю	zg
я	zg
