ㄚ	a
ㄚˉ	a
ㄚˊ	a
ㄚˇ	a
ㄚˋ	a
ㄚ˙	a
ㄞ	ai
ㄞˉ	ai
ㄞˊ	ai
ㄞˇ	ai
ㄞˋ	ai
ㄞ˙	ai
ㄢ	an
ㄢˉ	an
ㄢˊ	an
ㄢˇ	an
ㄢˋ	an
ㄢ˙	an
ㄤ	ang
ㄤˉ	ang
ㄤˊ	ang
ㄤˇ	ang
ㄤˋ	ang
ㄤ˙	ang
ㄠ	ao
ㄠˉ	ao
ㄠˊ	ao
ㄠˇ	ao
ㄠˋ	ao
ㄠ˙	ao
ㄅㄚ	ba
ㄅㄚˉ	ba
ㄅㄚˊ	ba
ㄅㄚˇ	ba
ㄅㄚˋ	ba
ㄅㄚ˙	ba
ㄅㄞ	bai
ㄅㄞˉ	bai
ㄅㄞˊ	bai
ㄅㄞˇ	bai
ㄅㄞˋ	bai
ㄅㄞ˙	bai
ㄅㄢ	ban
ㄅㄢˉ	ban
ㄅㄢˊ	ban
ㄅㄢˇ	ban
ㄅㄢˋ	ban
ㄅㄢ˙	ban
ㄅㄤ	bang
ㄅㄤˉ	bang
ㄅㄤˊ	bang
ㄅㄤˇ	bang
ㄅㄤˋ	bang
ㄅㄤ˙	bang
ㄅㄠ	bao
ㄅㄠˉ	bao
ㄅㄠˊ	bao
ㄅㄠˇ	bao
ㄅㄠˋ	bao
ㄅㄠ˙	bao
ㄅㄜ	be
ㄅㄜˉ	be
ㄅㄜˊ	be
ㄅㄜˇ	be
ㄅㄜˋ	be
ㄅㄜ˙	be
ㄅㄟ	bei
ㄅㄟˉ	bei
ㄅㄟˊ	bei
ㄅㄟˇ	bei
ㄅㄟˋ	bei
ㄅㄟ˙	bei
ㄅㄣ	ben
ㄅㄣˉ	ben
ㄅㄣˊ	ben
ㄅㄣˇ	ben
ㄅㄣˋ	ben
ㄅㄣ˙	ben
ㄅㄥ	beng
ㄅㄥˉ	beng
ㄅㄥˊ	beng
ㄅㄥˇ	beng
ㄅㄥˋ	beng
ㄅㄥ˙	beng
ㄅㄦ	ber
ㄅㄦˉ	ber
ㄅㄦˊ	ber
ㄅㄦˇ	ber
ㄅㄦˋ	ber
ㄅㄦ˙	ber
ㄅㄧ	bi
ㄅㄧˉ	bi
ㄅㄧˊ	bi
ㄅㄧˇ	bi
ㄅㄧˋ	bi
ㄅㄧ˙	bi
ㄅㄧㄚ	bia
ㄅㄧㄚˉ	bia
ㄅㄧㄚˊ	bia
ㄅㄧㄚˇ	bia
ㄅㄧㄚˋ	bia
ㄅㄧㄚ˙	bia
ㄅㄧㄢ	bian
ㄅㄧㄢˉ	bian
ㄅㄧㄢˊ	bian
ㄅㄧㄢˇ	bian
ㄅㄧㄢˋ	bian
ㄅㄧㄢ˙	bian
ㄅㄧㄤ	biang
ㄅㄧㄤˉ	biang
ㄅㄧㄤˊ	biang
ㄅㄧㄤˇ	biang
ㄅㄧㄤˋ	biang
ㄅㄧㄤ˙	biang
ㄅㄧㄠ	biao
ㄅㄧㄠˉ	biao
ㄅㄧㄠˊ	biao
ㄅㄧㄠˇ	biao
ㄅㄧㄠˋ	biao
ㄅㄧㄠ˙	biao
ㄅㄧㄝ	bie
ㄅㄧㄝˉ	bie
ㄅㄧㄝˊ	bie
ㄅㄧㄝˇ	bie
ㄅㄧㄝˋ	bie
ㄅㄧㄝ˙	bie
ㄅㄧㄣ	bin
ㄅㄧㄣˉ	bin
ㄅㄧㄣˊ	bin
ㄅㄧㄣˇ	bin
ㄅㄧㄣˋ	bin
ㄅㄧㄣ˙	bin
ㄅㄧㄥ	bing
ㄅㄧㄥˉ	bing
ㄅㄧㄥˊ	bing
ㄅㄧㄥˇ	bing
ㄅㄧㄥˋ	bing
ㄅㄧㄥ˙	bing
ㄅㄩㄥ	biong
ㄅㄩㄥˉ	biong
ㄅㄩㄥˊ	biong
ㄅㄩㄥˇ	biong
ㄅㄩㄥˋ	biong
ㄅㄩㄥ˙	biong
ㄅㄧㄡ	biou
ㄅㄧㄡˉ	biou
ㄅㄧㄡˊ	biou
ㄅㄧㄡˇ	biou
ㄅㄧㄡˋ	biou
ㄅㄧㄡ˙	biou
ㄅㄧㄡ	biu
ㄅㄧㄡˉ	biu
ㄅㄧㄡˊ	biu
ㄅㄧㄡˇ	biu
ㄅㄧㄡˋ	biu
ㄅㄧㄡ˙	biu
ㄅㄩㄥ	biung
ㄅㄩㄥˉ	biung
ㄅㄩㄥˊ	biung
ㄅㄩㄥˇ	biung
ㄅㄩㄥˋ	biung
ㄅㄩㄥ˙	biung
ㄅㄛ	bo
ㄅㄛˉ	bo
ㄅㄛˊ	bo
ㄅㄛˇ	bo
ㄅㄛˋ	bo
ㄅㄛ˙	bo
ㄅㄨㄥ	bong
ㄅㄨㄥˉ	bong
ㄅㄨㄥˊ	bong
ㄅㄨㄥˇ	bong
ㄅㄨㄥˋ	bong
ㄅㄨㄥ˙	bong
ㄅㄡ	bou
ㄅㄡˉ	bou
ㄅㄡˊ	bou
ㄅㄡˇ	bou
ㄅㄡˋ	bou
ㄅㄡ˙	bou
ㄅㄨ	bu
ㄅㄨˉ	bu
ㄅㄨˊ	bu
ㄅㄨˇ	bu
ㄅㄨˋ	bu
ㄅㄨ˙	bu
ㄅㄨㄚ	bua
ㄅㄨㄚˉ	bua
ㄅㄨㄚˊ	bua
ㄅㄨㄚˇ	bua
ㄅㄨㄚˋ	bua
ㄅㄨㄚ˙	bua
ㄅㄨㄞ	buai
ㄅㄨㄞˉ	buai
ㄅㄨㄞˊ	buai
ㄅㄨㄞˇ	buai
ㄅㄨㄞˋ	buai
ㄅㄨㄞ˙	buai
ㄅㄨㄢ	buan
ㄅㄨㄢˉ	buan
ㄅㄨㄢˊ	buan
ㄅㄨㄢˇ	buan
ㄅㄨㄢˋ	buan
ㄅㄨㄢ˙	buan
ㄅㄨㄤ	buang
ㄅㄨㄤˉ	buang
ㄅㄨㄤˊ	buang
ㄅㄨㄤˇ	buang
ㄅㄨㄤˋ	buang
ㄅㄨㄤ˙	buang
ㄅㄨㄟ	bui
ㄅㄨㄟˉ	bui
ㄅㄨㄟˊ	bui
ㄅㄨㄟˇ	bui
ㄅㄨㄟˋ	bui
ㄅㄨㄟ˙	bui
ㄅㄨㄣ	bun
ㄅㄨㄣˉ	bun
ㄅㄨㄣˊ	bun
ㄅㄨㄣˇ	bun
ㄅㄨㄣˋ	bun
ㄅㄨㄣ˙	bun
ㄅㄨㄥ	bung
ㄅㄨㄥˉ	bung
ㄅㄨㄥˊ	bung
ㄅㄨㄥˇ	bung
ㄅㄨㄥˋ	bung
ㄅㄨㄥ˙	bung
ㄅㄨㄛ	buo
ㄅㄨㄛˉ	buo
ㄅㄨㄛˊ	buo
ㄅㄨㄛˇ	buo
ㄅㄨㄛˋ	buo
ㄅㄨㄛ˙	buo
ㄅㄩ	bv
ㄅㄩˉ	bv
ㄅㄩˊ	bv
ㄅㄩˇ	bv
ㄅㄩˋ	bv
ㄅㄩ˙	bv
ㄅㄩㄝ	bve
ㄅㄩㄝˉ	bve
ㄅㄩㄝˊ	bve
ㄅㄩㄝˇ	bve
ㄅㄩㄝˋ	bve
ㄅㄩㄝ˙	bve
ㄅㄩㄣ	bvn
ㄅㄩㄣˉ	bvn
ㄅㄩㄣˊ	bvn
ㄅㄩㄣˇ	bvn
ㄅㄩㄣˋ	bvn
ㄅㄩㄣ˙	bvn
ㄅㄩㄥ	bvng
ㄅㄩㄥˉ	bvng
ㄅㄩㄥˊ	bvng
ㄅㄩㄥˇ	bvng
ㄅㄩㄥˋ	bvng
ㄅㄩㄥ˙	bvng
ㄅㄩ	byu
ㄅㄩˉ	byu
ㄅㄩˊ	byu
ㄅㄩˇ	byu
ㄅㄩˋ	byu
ㄅㄩ˙	byu
ㄅㄩㄝ	byue
ㄅㄩㄝˉ	byue
ㄅㄩㄝˊ	byue
ㄅㄩㄝˇ	byue
ㄅㄩㄝˋ	byue
ㄅㄩㄝ˙	byue
ㄅㄩㄣ	byun
ㄅㄩㄣˉ	byun
ㄅㄩㄣˊ	byun
ㄅㄩㄣˇ	byun
ㄅㄩㄣˋ	byun
ㄅㄩㄣ˙	byun
ㄅㄩㄥ	byung
ㄅㄩㄥˉ	byung
ㄅㄩㄥˊ	byung
ㄅㄩㄥˇ	byung
ㄅㄩㄥˋ	byung
ㄅㄩㄥ˙	byung
ㄘㄚ	ca
ㄘㄚˉ	ca
ㄘㄚˊ	ca
ㄘㄚˇ	ca
ㄘㄚˋ	ca
ㄘㄚ˙	ca
ㄘㄞ	cai
ㄘㄞˉ	cai
ㄘㄞˊ	cai
ㄘㄞˇ	cai
ㄘㄞˋ	cai
ㄘㄞ˙	cai
ㄘㄢ	can
ㄘㄢˉ	can
ㄘㄢˊ	can
ㄘㄢˇ	can
ㄘㄢˋ	can
ㄘㄢ˙	can
ㄘㄤ	cang
ㄘㄤˉ	cang
ㄘㄤˊ	cang
ㄘㄤˇ	cang
ㄘㄤˋ	cang
ㄘㄤ˙	cang
ㄘㄠ	cao
ㄘㄠˉ	cao
ㄘㄠˊ	cao
ㄘㄠˇ	cao
ㄘㄠˋ	cao
ㄘㄠ˙	cao
ㄘㄜ	ce
ㄘㄜˉ	ce
ㄘㄜˊ	ce
ㄘㄜˇ	ce
ㄘㄜˋ	ce
ㄘㄜ˙	ce
ㄘㄟ	cei
ㄘㄟˉ	cei
ㄘㄟˊ	cei
ㄘㄟˇ	cei
ㄘㄟˋ	cei
ㄘㄟ˙	cei
ㄘㄣ	cen
ㄘㄣˉ	cen
ㄘㄣˊ	cen
ㄘㄣˇ	cen
ㄘㄣˋ	cen
ㄘㄣ˙	cen
ㄘㄥ	ceng
ㄘㄥˉ	ceng
ㄘㄥˊ	ceng
ㄘㄥˇ	ceng
ㄘㄥˋ	ceng
ㄘㄥ˙	ceng
ㄘㄦ	cer
ㄘㄦˉ	cer
ㄘㄦˊ	cer
ㄘㄦˇ	cer
ㄘㄦˋ	cer
ㄘㄦ˙	cer
ㄔㄚ	cha
ㄔㄚˉ	cha
ㄔㄚˊ	cha
ㄔㄚˇ	cha
ㄔㄚˋ	cha
ㄔㄚ˙	cha
ㄔㄞ	chai
ㄔㄞˉ	chai
ㄔㄞˊ	chai
ㄔㄞˇ	chai
ㄔㄞˋ	chai
ㄔㄞ˙	chai
ㄔㄢ	chan
ㄔㄢˉ	chan
ㄔㄢˊ	chan
ㄔㄢˇ	chan
ㄔㄢˋ	chan
ㄔㄢ˙	chan
ㄔㄤ	chang
ㄔㄤˉ	chang
ㄔㄤˊ	chang
ㄔㄤˇ	chang
ㄔㄤˋ	chang
ㄔㄤ˙	chang
ㄔㄠ	chao
ㄔㄠˉ	chao
ㄔㄠˊ	chao
ㄔㄠˇ	chao
ㄔㄠˋ	chao
ㄔㄠ˙	chao
ㄔㄜ	che
ㄔㄜˉ	che
ㄔㄜˊ	che
ㄔㄜˇ	che
ㄔㄜˋ	che
ㄔㄜ˙	che
ㄔㄟ	chei
ㄔㄟˉ	chei
ㄔㄟˊ	chei
ㄔㄟˇ	chei
ㄔㄟˋ	chei
ㄔㄟ˙	chei
ㄔㄣ	chen
ㄔㄣˉ	chen
ㄔㄣˊ	chen
ㄔㄣˇ	chen
ㄔㄣˋ	chen
ㄔㄣ˙	chen
ㄔㄥ	cheng
ㄔㄥˉ	cheng
ㄔㄥˊ	cheng
ㄔㄥˇ	cheng
ㄔㄥˋ	cheng
ㄔㄥ˙	cheng
ㄔㄦ	cher
ㄔㄦˉ	cher
ㄔㄦˊ	cher
ㄔㄦˇ	cher
ㄔㄦˋ	cher
ㄔㄦ˙	cher
ㄔ	chi
ㄔˉ	chi
ㄔˊ	chi
ㄔˇ	chi
ㄔˋ	chi
ㄔ˙	chi
ㄔㄧ	chi
ㄔㄧˉ	chi
ㄔㄧˊ	chi
ㄔㄧˇ	chi
ㄔㄧˋ	chi
ㄔㄧ˙	chi
ㄔㄧㄚ	chia
ㄔㄧㄚˉ	chia
ㄔㄧㄚˊ	chia
ㄔㄧㄚˇ	chia
ㄔㄧㄚˋ	chia
ㄔㄧㄚ˙	chia
ㄔㄧㄢ	chian
ㄔㄧㄢˉ	chian
ㄔㄧㄢˊ	chian
ㄔㄧㄢˇ	chian
ㄔㄧㄢˋ	chian
ㄔㄧㄢ˙	chian
ㄔㄧㄤ	chiang
ㄔㄧㄤˉ	chiang
ㄔㄧㄤˊ	chiang
ㄔㄧㄤˇ	chiang
ㄔㄧㄤˋ	chiang
ㄔㄧㄤ˙	chiang
ㄔㄧㄠ	chiao
ㄔㄧㄠˉ	chiao
ㄔㄧㄠˊ	chiao
ㄔㄧㄠˇ	chiao
ㄔㄧㄠˋ	chiao
ㄔㄧㄠ˙	chiao
ㄔㄧㄝ	chie
ㄔㄧㄝˉ	chie
ㄔㄧㄝˊ	chie
ㄔㄧㄝˇ	chie
ㄔㄧㄝˋ	chie
ㄔㄧㄝ˙	chie
ㄔㄧㄣ	chin
ㄔㄧㄣˉ	chin
ㄔㄧㄣˊ	chin
ㄔㄧㄣˇ	chin
ㄔㄧㄣˋ	chin
ㄔㄧㄣ˙	chin
ㄔㄧㄥ	ching
ㄔㄧㄥˉ	ching
ㄔㄧㄥˊ	ching
ㄔㄧㄥˇ	ching
ㄔㄧㄥˋ	ching
ㄔㄧㄥ˙	ching
ㄔㄩㄥ	chiong
ㄔㄩㄥˉ	chiong
ㄔㄩㄥˊ	chiong
ㄔㄩㄥˇ	chiong
ㄔㄩㄥˋ	chiong
ㄔㄩㄥ˙	chiong
ㄔㄧㄡ	chiou
ㄔㄧㄡˉ	chiou
ㄔㄧㄡˊ	chiou
ㄔㄧㄡˇ	chiou
ㄔㄧㄡˋ	chiou
ㄔㄧㄡ˙	chiou
ㄔㄧㄡ	chiu
ㄔㄧㄡˉ	chiu
ㄔㄧㄡˊ	chiu
ㄔㄧㄡˇ	chiu
ㄔㄧㄡˋ	chiu
ㄔㄧㄡ˙	chiu
ㄔㄩㄥ	chiung
ㄔㄩㄥˉ	chiung
ㄔㄩㄥˊ	chiung
ㄔㄩㄥˇ	chiung
ㄔㄩㄥˋ	chiung
ㄔㄩㄥ˙	chiung
ㄔㄛ	cho
ㄔㄛˉ	cho
ㄔㄛˊ	cho
ㄔㄛˇ	cho
ㄔㄛˋ	cho
ㄔㄛ˙	cho
ㄔㄨㄥ	chong
ㄔㄨㄥˉ	chong
ㄔㄨㄥˊ	chong
ㄔㄨㄥˇ	chong
ㄔㄨㄥˋ	chong
ㄔㄨㄥ˙	chong
ㄔㄡ	chou
ㄔㄡˉ	chou
ㄔㄡˊ	chou
ㄔㄡˇ	chou
ㄔㄡˋ	chou
ㄔㄡ˙	chou
ㄔㄨ	chu
ㄔㄨˉ	chu
ㄔㄨˊ	chu
ㄔㄨˇ	chu
ㄔㄨˋ	chu
ㄔㄨ˙	chu
ㄔㄨㄚ	chua
ㄔㄨㄚˉ	chua
ㄔㄨㄚˊ	chua
ㄔㄨㄚˇ	chua
ㄔㄨㄚˋ	chua
ㄔㄨㄚ˙	chua
ㄔㄨㄞ	chuai
ㄔㄨㄞˉ	chuai
ㄔㄨㄞˊ	chuai
ㄔㄨㄞˇ	chuai
ㄔㄨㄞˋ	chuai
ㄔㄨㄞ˙	chuai
ㄔㄨㄢ	chuan
ㄔㄨㄢˉ	chuan
ㄔㄨㄢˊ	chuan
ㄔㄨㄢˇ	chuan
ㄔㄨㄢˋ	chuan
ㄔㄨㄢ˙	chuan
ㄔㄨㄤ	chuang
ㄔㄨㄤˉ	chuang
ㄔㄨㄤˊ	chuang
ㄔㄨㄤˇ	chuang
ㄔㄨㄤˋ	chuang
ㄔㄨㄤ˙	chuang
ㄔㄨㄟ	chui
ㄔㄨㄟˉ	chui
ㄔㄨㄟˊ	chui
ㄔㄨㄟˇ	chui
ㄔㄨㄟˋ	chui
ㄔㄨㄟ˙	chui
ㄔㄨㄣ	chun
ㄔㄨㄣˉ	chun
ㄔㄨㄣˊ	chun
ㄔㄨㄣˇ	chun
ㄔㄨㄣˋ	chun
ㄔㄨㄣ˙	chun
ㄔㄨㄥ	chung
ㄔㄨㄥˉ	chung
ㄔㄨㄥˊ	chung
ㄔㄨㄥˇ	chung
ㄔㄨㄥˋ	chung
ㄔㄨㄥ˙	chung
ㄔㄨㄛ	chuo
ㄔㄨㄛˉ	chuo
ㄔㄨㄛˊ	chuo
ㄔㄨㄛˇ	chuo
ㄔㄨㄛˋ	chuo
ㄔㄨㄛ˙	chuo
ㄔㄩ	chv
ㄔㄩˉ	chv
ㄔㄩˊ	chv
ㄔㄩˇ	chv
ㄔㄩˋ	chv
ㄔㄩ˙	chv
ㄔㄩㄝ	chve
ㄔㄩㄝˉ	chve
ㄔㄩㄝˊ	chve
ㄔㄩㄝˇ	chve
ㄔㄩㄝˋ	chve
ㄔㄩㄝ˙	chve
ㄔㄩㄣ	chvn
ㄔㄩㄣˉ	chvn
ㄔㄩㄣˊ	chvn
ㄔㄩㄣˇ	chvn
ㄔㄩㄣˋ	chvn
ㄔㄩㄣ˙	chvn
ㄔㄩㄥ	chvng
ㄔㄩㄥˉ	chvng
ㄔㄩㄥˊ	chvng
ㄔㄩㄥˇ	chvng
ㄔㄩㄥˋ	chvng
ㄔㄩㄥ˙	chvng
ㄔㄩ	chyu
ㄔㄩˉ	chyu
ㄔㄩˊ	chyu
ㄔㄩˇ	chyu
ㄔㄩˋ	chyu
ㄔㄩ˙	chyu
ㄔㄩㄝ	chyue
ㄔㄩㄝˉ	chyue
ㄔㄩㄝˊ	chyue
ㄔㄩㄝˇ	chyue
ㄔㄩㄝˋ	chyue
ㄔㄩㄝ˙	chyue
ㄔㄩㄣ	chyun
ㄔㄩㄣˉ	chyun
ㄔㄩㄣˊ	chyun
ㄔㄩㄣˇ	chyun
ㄔㄩㄣˋ	chyun
ㄔㄩㄣ˙	chyun
ㄔㄩㄥ	chyung
ㄔㄩㄥˉ	chyung
ㄔㄩㄥˊ	chyung
ㄔㄩㄥˇ	chyung
ㄔㄩㄥˋ	chyung
ㄔㄩㄥ˙	chyung
ㄘ	ci
ㄘˉ	ci
ㄘˊ	ci
ㄘˇ	ci
ㄘˋ	ci
ㄘ˙	ci
ㄘㄧ	ci
ㄘㄧˉ	ci
ㄘㄧˊ	ci
ㄘㄧˇ	ci
ㄘㄧˋ	ci
ㄘㄧ˙	ci
ㄘㄧㄚ	cia
ㄘㄧㄚˉ	cia
ㄘㄧㄚˊ	cia
ㄘㄧㄚˇ	cia
ㄘㄧㄚˋ	cia
ㄘㄧㄚ˙	cia
ㄘㄧㄢ	cian
ㄘㄧㄢˉ	cian
ㄘㄧㄢˊ	cian
ㄘㄧㄢˇ	cian
ㄘㄧㄢˋ	cian
ㄘㄧㄢ˙	cian
ㄘㄧㄤ	ciang
ㄘㄧㄤˉ	ciang
ㄘㄧㄤˊ	ciang
ㄘㄧㄤˇ	ciang
ㄘㄧㄤˋ	ciang
ㄘㄧㄤ˙	ciang
ㄘㄧㄠ	ciao
ㄘㄧㄠˉ	ciao
ㄘㄧㄠˊ	ciao
ㄘㄧㄠˇ	ciao
ㄘㄧㄠˋ	ciao
ㄘㄧㄠ˙	ciao
ㄘㄧㄝ	cie
ㄘㄧㄝˉ	cie
ㄘㄧㄝˊ	cie
ㄘㄧㄝˇ	cie
ㄘㄧㄝˋ	cie
ㄘㄧㄝ˙	cie
ㄘㄧㄣ	cin
ㄘㄧㄣˉ	cin
ㄘㄧㄣˊ	cin
ㄘㄧㄣˇ	cin
ㄘㄧㄣˋ	cin
ㄘㄧㄣ˙	cin
ㄘㄧㄥ	cing
ㄘㄧㄥˉ	cing
ㄘㄧㄥˊ	cing
ㄘㄧㄥˇ	cing
ㄘㄧㄥˋ	cing
ㄘㄧㄥ˙	cing
ㄘㄩㄥ	ciong
ㄘㄩㄥˉ	ciong
ㄘㄩㄥˊ	ciong
ㄘㄩㄥˇ	ciong
ㄘㄩㄥˋ	ciong
ㄘㄩㄥ˙	ciong
ㄘㄧㄡ	ciou
ㄘㄧㄡˉ	ciou
ㄘㄧㄡˊ	ciou
ㄘㄧㄡˇ	ciou
ㄘㄧㄡˋ	ciou
ㄘㄧㄡ˙	ciou
ㄘㄧㄡ	ciu
ㄘㄧㄡˉ	ciu
ㄘㄧㄡˊ	ciu
ㄘㄧㄡˇ	ciu
ㄘㄧㄡˋ	ciu
ㄘㄧㄡ˙	ciu
ㄘㄩㄥ	ciung
ㄘㄩㄥˉ	ciung
ㄘㄩㄥˊ	ciung
ㄘㄩㄥˇ	ciung
ㄘㄩㄥˋ	ciung
ㄘㄩㄥ˙	ciung
ㄘㄛ	co
ㄘㄛˉ	co
ㄘㄛˊ	co
ㄘㄛˇ	co
ㄘㄛˋ	co
ㄘㄛ˙	co
ㄘㄨㄥ	cong
ㄘㄨㄥˉ	cong
ㄘㄨㄥˊ	cong
ㄘㄨㄥˇ	cong
ㄘㄨㄥˋ	cong
ㄘㄨㄥ˙	cong
ㄘㄡ	cou
ㄘㄡˉ	cou
ㄘㄡˊ	cou
ㄘㄡˇ	cou
ㄘㄡˋ	cou
ㄘㄡ˙	cou
ㄘㄨ	cu
ㄘㄨˉ	cu
ㄘㄨˊ	cu
ㄘㄨˇ	cu
ㄘㄨˋ	cu
ㄘㄨ˙	cu
ㄘㄨㄚ	cua
ㄘㄨㄚˉ	cua
ㄘㄨㄚˊ	cua
ㄘㄨㄚˇ	cua
ㄘㄨㄚˋ	cua
ㄘㄨㄚ˙	cua
ㄘㄨㄞ	cuai
ㄘㄨㄞˉ	cuai
ㄘㄨㄞˊ	cuai
ㄘㄨㄞˇ	cuai
ㄘㄨㄞˋ	cuai
ㄘㄨㄞ˙	cuai
ㄘㄨㄢ	cuan
ㄘㄨㄢˉ	cuan
ㄘㄨㄢˊ	cuan
ㄘㄨㄢˇ	cuan
ㄘㄨㄢˋ	cuan
ㄘㄨㄢ˙	cuan
ㄘㄨㄤ	cuang
ㄘㄨㄤˉ	cuang
ㄘㄨㄤˊ	cuang
ㄘㄨㄤˇ	cuang
ㄘㄨㄤˋ	cuang
ㄘㄨㄤ˙	cuang
ㄘㄨㄟ	cui
ㄘㄨㄟˉ	cui
ㄘㄨㄟˊ	cui
ㄘㄨㄟˇ	cui
ㄘㄨㄟˋ	cui
ㄘㄨㄟ˙	cui
ㄘㄨㄣ	cun
ㄘㄨㄣˉ	cun
ㄘㄨㄣˊ	cun
ㄘㄨㄣˇ	cun
ㄘㄨㄣˋ	cun
ㄘㄨㄣ˙	cun
ㄘㄨㄥ	cung
ㄘㄨㄥˉ	cung
ㄘㄨㄥˊ	cung
ㄘㄨㄥˇ	cung
ㄘㄨㄥˋ	cung
ㄘㄨㄥ˙	cung
ㄘㄨㄛ	cuo
ㄘㄨㄛˉ	cuo
ㄘㄨㄛˊ	cuo
ㄘㄨㄛˇ	cuo
ㄘㄨㄛˋ	cuo
ㄘㄨㄛ˙	cuo
ㄘㄩ	cv
ㄘㄩˉ	cv
ㄘㄩˊ	cv
ㄘㄩˇ	cv
ㄘㄩˋ	cv
ㄘㄩ˙	cv
ㄘㄩㄝ	cve
ㄘㄩㄝˉ	cve
ㄘㄩㄝˊ	cve
ㄘㄩㄝˇ	cve
ㄘㄩㄝˋ	cve
ㄘㄩㄝ˙	cve
ㄘㄩㄣ	cvn
ㄘㄩㄣˉ	cvn
ㄘㄩㄣˊ	cvn
ㄘㄩㄣˇ	cvn
ㄘㄩㄣˋ	cvn
ㄘㄩㄣ˙	cvn
ㄘㄩㄥ	cvng
ㄘㄩㄥˉ	cvng
ㄘㄩㄥˊ	cvng
ㄘㄩㄥˇ	cvng
ㄘㄩㄥˋ	cvng
ㄘㄩㄥ˙	cvng
ㄘㄩ	cyu
ㄘㄩˉ	cyu
ㄘㄩˊ	cyu
ㄘㄩˇ	cyu
ㄘㄩˋ	cyu
ㄘㄩ˙	cyu
ㄘㄩㄝ	cyue
ㄘㄩㄝˉ	cyue
ㄘㄩㄝˊ	cyue
ㄘㄩㄝˇ	cyue
ㄘㄩㄝˋ	cyue
ㄘㄩㄝ˙	cyue
ㄘㄩㄣ	cyun
ㄘㄩㄣˉ	cyun
ㄘㄩㄣˊ	cyun
ㄘㄩㄣˇ	cyun
ㄘㄩㄣˋ	cyun
ㄘㄩㄣ˙	cyun
ㄘㄩㄥ	cyung
ㄘㄩㄥˉ	cyung
ㄘㄩㄥˊ	cyung
ㄘㄩㄥˇ	cyung
ㄘㄩㄥˋ	cyung
ㄘㄩㄥ˙	cyung
ㄉㄚ	da
ㄉㄚˉ	da
ㄉㄚˊ	da
ㄉㄚˇ	da
ㄉㄚˋ	da
ㄉㄚ˙	da
ㄉㄞ	dai
ㄉㄞˉ	dai
ㄉㄞˊ	dai
ㄉㄞˇ	dai
ㄉㄞˋ	dai
ㄉㄞ˙	dai
ㄉㄢ	dan
ㄉㄢˉ	dan
ㄉㄢˊ	dan
ㄉㄢˇ	dan
ㄉㄢˋ	dan
ㄉㄢ˙	dan
ㄉㄤ	dang
ㄉㄤˉ	dang
ㄉㄤˊ	dang
ㄉㄤˇ	dang
ㄉㄤˋ	dang
ㄉㄤ˙	dang
ㄉㄠ	dao
ㄉㄠˉ	dao
ㄉㄠˊ	dao
ㄉㄠˇ	dao
ㄉㄠˋ	dao
ㄉㄠ˙	dao
ㄉㄜ	de
ㄉㄜˉ	de
ㄉㄜˊ	de
ㄉㄜˇ	de
ㄉㄜˋ	de
ㄉㄜ˙	de
ㄉㄟ	dei
ㄉㄟˉ	dei
ㄉㄟˊ	dei
ㄉㄟˇ	dei
ㄉㄟˋ	dei
ㄉㄟ˙	dei
ㄉㄣ	den
ㄉㄣˉ	den
ㄉㄣˊ	den
ㄉㄣˇ	den
ㄉㄣˋ	den
ㄉㄣ˙	den
ㄉㄥ	deng
ㄉㄥˉ	deng
ㄉㄥˊ	deng
ㄉㄥˇ	deng
ㄉㄥˋ	deng
ㄉㄥ˙	deng
ㄉㄦ	der
ㄉㄦˉ	der
ㄉㄦˊ	der
ㄉㄦˇ	der
ㄉㄦˋ	der
ㄉㄦ˙	der
ㄉㄧ	di
ㄉㄧˉ	di
ㄉㄧˊ	di
ㄉㄧˇ	di
ㄉㄧˋ	di
ㄉㄧ˙	di
ㄉㄧㄚ	dia
ㄉㄧㄚˉ	dia
ㄉㄧㄚˊ	dia
ㄉㄧㄚˇ	dia
ㄉㄧㄚˋ	dia
ㄉㄧㄚ˙	dia
ㄉㄧㄢ	dian
ㄉㄧㄢˉ	dian
ㄉㄧㄢˊ	dian
ㄉㄧㄢˇ	dian
ㄉㄧㄢˋ	dian
ㄉㄧㄢ˙	dian
ㄉㄧㄤ	diang
ㄉㄧㄤˉ	diang
ㄉㄧㄤˊ	diang
ㄉㄧㄤˇ	diang
ㄉㄧㄤˋ	diang
ㄉㄧㄤ˙	diang
ㄉㄧㄠ	diao
ㄉㄧㄠˉ	diao
ㄉㄧㄠˊ	diao
ㄉㄧㄠˇ	diao
ㄉㄧㄠˋ	diao
ㄉㄧㄠ˙	diao
ㄉㄧㄝ	die
ㄉㄧㄝˉ	die
ㄉㄧㄝˊ	die
ㄉㄧㄝˇ	die
ㄉㄧㄝˋ	die
ㄉㄧㄝ˙	die
ㄉㄧㄣ	din
ㄉㄧㄣˉ	din
ㄉㄧㄣˊ	din
ㄉㄧㄣˇ	din
ㄉㄧㄣˋ	din
ㄉㄧㄣ˙	din
ㄉㄧㄥ	ding
ㄉㄧㄥˉ	ding
ㄉㄧㄥˊ	ding
ㄉㄧㄥˇ	ding
ㄉㄧㄥˋ	ding
ㄉㄧㄥ˙	ding
ㄉㄩㄥ	diong
ㄉㄩㄥˉ	diong
ㄉㄩㄥˊ	diong
ㄉㄩㄥˇ	diong
ㄉㄩㄥˋ	diong
ㄉㄩㄥ˙	diong
ㄉㄧㄡ	diou
ㄉㄧㄡˉ	diou
ㄉㄧㄡˊ	diou
ㄉㄧㄡˇ	diou
ㄉㄧㄡˋ	diou
ㄉㄧㄡ˙	diou
ㄉㄧㄡ	diu
ㄉㄧㄡˉ	diu
ㄉㄧㄡˊ	diu
ㄉㄧㄡˇ	diu
ㄉㄧㄡˋ	diu
ㄉㄧㄡ˙	diu
ㄉㄩㄥ	diung
ㄉㄩㄥˉ	diung
ㄉㄩㄥˊ	diung
ㄉㄩㄥˇ	diung
ㄉㄩㄥˋ	diung
ㄉㄩㄥ˙	diung
ㄉㄛ	do
ㄉㄛˉ	do
ㄉㄛˊ	do
ㄉㄛˇ	do
ㄉㄛˋ	do
ㄉㄛ˙	do
ㄉㄨㄥ	dong
ㄉㄨㄥˉ	dong
ㄉㄨㄥˊ	dong
ㄉㄨㄥˇ	dong
ㄉㄨㄥˋ	dong
ㄉㄨㄥ˙	dong
ㄉㄡ	dou
ㄉㄡˉ	dou
ㄉㄡˊ	dou
ㄉㄡˇ	dou
ㄉㄡˋ	dou
ㄉㄡ˙	dou
ㄉㄨ	du
ㄉㄨˉ	du
ㄉㄨˊ	du
ㄉㄨˇ	du
ㄉㄨˋ	du
ㄉㄨ˙	du
ㄉㄨㄚ	dua
ㄉㄨㄚˉ	dua
ㄉㄨㄚˊ	dua
ㄉㄨㄚˇ	dua
ㄉㄨㄚˋ	dua
ㄉㄨㄚ˙	dua
ㄉㄨㄞ	duai
ㄉㄨㄞˉ	duai
ㄉㄨㄞˊ	duai
ㄉㄨㄞˇ	duai
ㄉㄨㄞˋ	duai
ㄉㄨㄞ˙	duai
ㄉㄨㄢ	duan
ㄉㄨㄢˉ	duan
ㄉㄨㄢˊ	duan
ㄉㄨㄢˇ	duan
ㄉㄨㄢˋ	duan
ㄉㄨㄢ˙	duan
ㄉㄨㄤ	duang
ㄉㄨㄤˉ	duang
ㄉㄨㄤˊ	duang
ㄉㄨㄤˇ	duang
ㄉㄨㄤˋ	duang
ㄉㄨㄤ˙	duang
ㄉㄨㄟ	dui
ㄉㄨㄟˉ	dui
ㄉㄨㄟˊ	dui
ㄉㄨㄟˇ	dui
ㄉㄨㄟˋ	dui
ㄉㄨㄟ˙	dui
ㄉㄨㄣ	dun
ㄉㄨㄣˉ	dun
ㄉㄨㄣˊ	dun
ㄉㄨㄣˇ	dun
ㄉㄨㄣˋ	dun
ㄉㄨㄣ˙	dun
ㄉㄨㄥ	dung
ㄉㄨㄥˉ	dung
ㄉㄨㄥˊ	dung
ㄉㄨㄥˇ	dung
ㄉㄨㄥˋ	dung
ㄉㄨㄥ˙	dung
ㄉㄨㄛ	duo
ㄉㄨㄛˉ	duo
ㄉㄨㄛˊ	duo
ㄉㄨㄛˇ	duo
ㄉㄨㄛˋ	duo
ㄉㄨㄛ˙	duo
ㄉㄩ	dv
ㄉㄩˉ	dv
ㄉㄩˊ	dv
ㄉㄩˇ	dv
ㄉㄩˋ	dv
ㄉㄩ˙	dv
ㄉㄩㄝ	dve
ㄉㄩㄝˉ	dve
ㄉㄩㄝˊ	dve
ㄉㄩㄝˇ	dve
ㄉㄩㄝˋ	dve
ㄉㄩㄝ˙	dve
ㄉㄩㄣ	dvn
ㄉㄩㄣˉ	dvn
ㄉㄩㄣˊ	dvn
ㄉㄩㄣˇ	dvn
ㄉㄩㄣˋ	dvn
ㄉㄩㄣ˙	dvn
ㄉㄩㄥ	dvng
ㄉㄩㄥˉ	dvng
ㄉㄩㄥˊ	dvng
ㄉㄩㄥˇ	dvng
ㄉㄩㄥˋ	dvng
ㄉㄩㄥ˙	dvng
ㄉㄩ	dyu
ㄉㄩˉ	dyu
ㄉㄩˊ	dyu
ㄉㄩˇ	dyu
ㄉㄩˋ	dyu
ㄉㄩ˙	dyu
ㄉㄩㄝ	dyue
ㄉㄩㄝˉ	dyue
ㄉㄩㄝˊ	dyue
ㄉㄩㄝˇ	dyue
ㄉㄩㄝˋ	dyue
ㄉㄩㄝ˙	dyue
ㄉㄩㄣ	dyun
ㄉㄩㄣˉ	dyun
ㄉㄩㄣˊ	dyun
ㄉㄩㄣˇ	dyun
ㄉㄩㄣˋ	dyun
ㄉㄩㄣ˙	dyun
ㄉㄩㄥ	dyung
ㄉㄩㄥˉ	dyung
ㄉㄩㄥˊ	dyung
ㄉㄩㄥˇ	dyung
ㄉㄩㄥˋ	dyung
ㄉㄩㄥ˙	dyung
ㄜ	e
ㄜˉ	e
ㄜˊ	e
ㄜˇ	e
ㄜˋ	e
ㄜ˙	e
ㄟ	ei
ㄟˉ	ei
ㄟˊ	ei
ㄟˇ	ei
ㄟˋ	ei
ㄟ˙	ei
ㄣ	en
ㄣˉ	en
ㄣˊ	en
ㄣˇ	en
ㄣˋ	en
ㄣ˙	en
ㄥ	eng
ㄥˉ	eng
ㄥˊ	eng
ㄥˇ	eng
ㄥˋ	eng
ㄥ˙	eng
ㄦ	er
ㄦˉ	er
ㄦˊ	er
ㄦˇ	er
ㄦˋ	er
ㄦ˙	er
ㄈㄚ	fa
ㄈㄚˉ	fa
ㄈㄚˊ	fa
ㄈㄚˇ	fa
ㄈㄚˋ	fa
ㄈㄚ˙	fa
ㄈㄞ	fai
ㄈㄞˉ	fai
ㄈㄞˊ	fai
ㄈㄞˇ	fai
ㄈㄞˋ	fai
ㄈㄞ˙	fai
ㄈㄢ	fan
ㄈㄢˉ	fan
ㄈㄢˊ	fan
ㄈㄢˇ	fan
ㄈㄢˋ	fan
ㄈㄢ˙	fan
ㄈㄤ	fang
ㄈㄤˉ	fang
ㄈㄤˊ	fang
ㄈㄤˇ	fang
ㄈㄤˋ	fang
ㄈㄤ˙	fang
ㄈㄠ	fao
ㄈㄠˉ	fao
ㄈㄠˊ	fao
ㄈㄠˇ	fao
ㄈㄠˋ	fao
ㄈㄠ˙	fao
ㄈㄜ	fe
ㄈㄜˉ	fe
ㄈㄜˊ	fe
ㄈㄜˇ	fe
ㄈㄜˋ	fe
ㄈㄜ˙	fe
ㄈㄟ	fei
ㄈㄟˉ	fei
ㄈㄟˊ	fei
ㄈㄟˇ	fei
ㄈㄟˋ	fei
ㄈㄟ˙	fei
ㄈㄣ	fen
ㄈㄣˉ	fen
ㄈㄣˊ	fen
ㄈㄣˇ	fen
ㄈㄣˋ	fen
ㄈㄣ˙	fen
ㄈㄥ	feng
ㄈㄥˉ	feng
ㄈㄥˊ	feng
ㄈㄥˇ	feng
ㄈㄥˋ	feng
ㄈㄥ˙	feng
ㄈㄦ	fer
ㄈㄦˉ	fer
ㄈㄦˊ	fer
ㄈㄦˇ	fer
ㄈㄦˋ	fer
ㄈㄦ˙	fer
ㄈㄧ	fi
ㄈㄧˉ	fi
ㄈㄧˊ	fi
ㄈㄧˇ	fi
ㄈㄧˋ	fi
ㄈㄧ˙	fi
ㄈㄧㄚ	fia
ㄈㄧㄚˉ	fia
ㄈㄧㄚˊ	fia
ㄈㄧㄚˇ	fia
ㄈㄧㄚˋ	fia
ㄈㄧㄚ˙	fia
ㄈㄧㄢ	fian
ㄈㄧㄢˉ	fian
ㄈㄧㄢˊ	fian
ㄈㄧㄢˇ	fian
ㄈㄧㄢˋ	fian
ㄈㄧㄢ˙	fian
ㄈㄧㄤ	fiang
ㄈㄧㄤˉ	fiang
ㄈㄧㄤˊ	fiang
ㄈㄧㄤˇ	fiang
ㄈㄧㄤˋ	fiang
ㄈㄧㄤ˙	fiang
ㄈㄧㄠ	fiao
ㄈㄧㄠˉ	fiao
ㄈㄧㄠˊ	fiao
ㄈㄧㄠˇ	fiao
ㄈㄧㄠˋ	fiao
ㄈㄧㄠ˙	fiao
ㄈㄧㄝ	fie
ㄈㄧㄝˉ	fie
ㄈㄧㄝˊ	fie
ㄈㄧㄝˇ	fie
ㄈㄧㄝˋ	fie
ㄈㄧㄝ˙	fie
ㄈㄧㄣ	fin
ㄈㄧㄣˉ	fin
ㄈㄧㄣˊ	fin
ㄈㄧㄣˇ	fin
ㄈㄧㄣˋ	fin
ㄈㄧㄣ˙	fin
ㄈㄧㄥ	fing
ㄈㄧㄥˉ	fing
ㄈㄧㄥˊ	fing
ㄈㄧㄥˇ	fing
ㄈㄧㄥˋ	fing
ㄈㄧㄥ˙	fing
ㄈㄩㄥ	fiong
ㄈㄩㄥˉ	fiong
ㄈㄩㄥˊ	fiong
ㄈㄩㄥˇ	fiong
ㄈㄩㄥˋ	fiong
ㄈㄩㄥ˙	fiong
ㄈㄧㄡ	fiou
ㄈㄧㄡˉ	fiou
ㄈㄧㄡˊ	fiou
ㄈㄧㄡˇ	fiou
ㄈㄧㄡˋ	fiou
ㄈㄧㄡ˙	fiou
ㄈㄧㄡ	fiu
ㄈㄧㄡˉ	fiu
ㄈㄧㄡˊ	fiu
ㄈㄧㄡˇ	fiu
ㄈㄧㄡˋ	fiu
ㄈㄧㄡ˙	fiu
ㄈㄩㄥ	fiung
ㄈㄩㄥˉ	fiung
ㄈㄩㄥˊ	fiung
ㄈㄩㄥˇ	fiung
ㄈㄩㄥˋ	fiung
ㄈㄩㄥ˙	fiung
ㄈㄛ	fo
ㄈㄛˉ	fo
ㄈㄛˊ	fo
ㄈㄛˇ	fo
ㄈㄛˋ	fo
ㄈㄛ˙	fo
ㄈㄨㄥ	fong
ㄈㄨㄥˉ	fong
ㄈㄨㄥˊ	fong
ㄈㄨㄥˇ	fong
ㄈㄨㄥˋ	fong
ㄈㄨㄥ˙	fong
ㄈㄡ	fou
ㄈㄡˉ	fou
ㄈㄡˊ	fou
ㄈㄡˇ	fou
ㄈㄡˋ	fou
ㄈㄡ˙	fou
ㄈㄨ	fu
ㄈㄨˉ	fu
ㄈㄨˊ	fu
ㄈㄨˇ	fu
ㄈㄨˋ	fu
ㄈㄨ˙	fu
ㄈㄨㄚ	fua
ㄈㄨㄚˉ	fua
ㄈㄨㄚˊ	fua
ㄈㄨㄚˇ	fua
ㄈㄨㄚˋ	fua
ㄈㄨㄚ˙	fua
ㄈㄨㄞ	fuai
ㄈㄨㄞˉ	fuai
ㄈㄨㄞˊ	fuai
ㄈㄨㄞˇ	fuai
ㄈㄨㄞˋ	fuai
ㄈㄨㄞ˙	fuai
ㄈㄨㄢ	fuan
ㄈㄨㄢˉ	fuan
ㄈㄨㄢˊ	fuan
ㄈㄨㄢˇ	fuan
ㄈㄨㄢˋ	fuan
ㄈㄨㄢ˙	fuan
ㄈㄨㄤ	fuang
ㄈㄨㄤˉ	fuang
ㄈㄨㄤˊ	fuang
ㄈㄨㄤˇ	fuang
ㄈㄨㄤˋ	fuang
ㄈㄨㄤ˙	fuang
ㄈㄨㄟ	fui
ㄈㄨㄟˉ	fui
ㄈㄨㄟˊ	fui
ㄈㄨㄟˇ	fui
ㄈㄨㄟˋ	fui
ㄈㄨㄟ˙	fui
ㄈㄨㄣ	fun
ㄈㄨㄣˉ	fun
ㄈㄨㄣˊ	fun
ㄈㄨㄣˇ	fun
ㄈㄨㄣˋ	fun
ㄈㄨㄣ˙	fun
ㄈㄨㄥ	fung
ㄈㄨㄥˉ	fung
ㄈㄨㄥˊ	fung
ㄈㄨㄥˇ	fung
ㄈㄨㄥˋ	fung
ㄈㄨㄥ˙	fung
ㄈㄨㄛ	fuo
ㄈㄨㄛˉ	fuo
ㄈㄨㄛˊ	fuo
ㄈㄨㄛˇ	fuo
ㄈㄨㄛˋ	fuo
ㄈㄨㄛ˙	fuo
ㄈㄩ	fv
ㄈㄩˉ	fv
ㄈㄩˊ	fv
ㄈㄩˇ	fv
ㄈㄩˋ	fv
ㄈㄩ˙	fv
ㄈㄩㄝ	fve
ㄈㄩㄝˉ	fve
ㄈㄩㄝˊ	fve
ㄈㄩㄝˇ	fve
ㄈㄩㄝˋ	fve
ㄈㄩㄝ˙	fve
ㄈㄩㄣ	fvn
ㄈㄩㄣˉ	fvn
ㄈㄩㄣˊ	fvn
ㄈㄩㄣˇ	fvn
ㄈㄩㄣˋ	fvn
ㄈㄩㄣ˙	fvn
ㄈㄩㄥ	fvng
ㄈㄩㄥˉ	fvng
ㄈㄩㄥˊ	fvng
ㄈㄩㄥˇ	fvng
ㄈㄩㄥˋ	fvng
ㄈㄩㄥ˙	fvng
ㄈㄩ	fyu
ㄈㄩˉ	fyu
ㄈㄩˊ	fyu
ㄈㄩˇ	fyu
ㄈㄩˋ	fyu
ㄈㄩ˙	fyu
ㄈㄩㄝ	fyue
ㄈㄩㄝˉ	fyue
ㄈㄩㄝˊ	fyue
ㄈㄩㄝˇ	fyue
ㄈㄩㄝˋ	fyue
ㄈㄩㄝ˙	fyue
ㄈㄩㄣ	fyun
ㄈㄩㄣˉ	fyun
ㄈㄩㄣˊ	fyun
ㄈㄩㄣˇ	fyun
ㄈㄩㄣˋ	fyun
ㄈㄩㄣ˙	fyun
ㄈㄩㄥ	fyung
ㄈㄩㄥˉ	fyung
ㄈㄩㄥˊ	fyung
ㄈㄩㄥˇ	fyung
ㄈㄩㄥˋ	fyung
ㄈㄩㄥ˙	fyung
ㄍㄚ	ga
ㄍㄚˉ	ga
ㄍㄚˊ	ga
ㄍㄚˇ	ga
ㄍㄚˋ	ga
ㄍㄚ˙	ga
ㄍㄞ	gai
ㄍㄞˉ	gai
ㄍㄞˊ	gai
ㄍㄞˇ	gai
ㄍㄞˋ	gai
ㄍㄞ˙	gai
ㄍㄢ	gan
ㄍㄢˉ	gan
ㄍㄢˊ	gan
ㄍㄢˇ	gan
ㄍㄢˋ	gan
ㄍㄢ˙	gan
ㄍㄤ	gang
ㄍㄤˉ	gang
ㄍㄤˊ	gang
ㄍㄤˇ	gang
ㄍㄤˋ	gang
ㄍㄤ˙	gang
ㄍㄠ	gao
ㄍㄠˉ	gao
ㄍㄠˊ	gao
ㄍㄠˇ	gao
ㄍㄠˋ	gao
ㄍㄠ˙	gao
ㄍㄜ	ge
ㄍㄜˉ	ge
ㄍㄜˊ	ge
ㄍㄜˇ	ge
ㄍㄜˋ	ge
ㄍㄜ˙	ge
ㄍㄟ	gei
ㄍㄟˉ	gei
ㄍㄟˊ	gei
ㄍㄟˇ	gei
ㄍㄟˋ	gei
ㄍㄟ˙	gei
ㄍㄣ	gen
ㄍㄣˉ	gen
ㄍㄣˊ	gen
ㄍㄣˇ	gen
ㄍㄣˋ	gen
ㄍㄣ˙	gen
ㄍㄥ	geng
ㄍㄥˉ	geng
ㄍㄥˊ	geng
ㄍㄥˇ	geng
ㄍㄥˋ	geng
ㄍㄥ˙	geng
ㄍㄦ	ger
ㄍㄦˉ	ger
ㄍㄦˊ	ger
ㄍㄦˇ	ger
ㄍㄦˋ	ger
ㄍㄦ˙	ger
ㄍㄧ	gi
ㄍㄧˉ	gi
ㄍㄧˊ	gi
ㄍㄧˇ	gi
ㄍㄧˋ	gi
ㄍㄧ˙	gi
ㄍㄧㄚ	gia
ㄍㄧㄚˉ	gia
ㄍㄧㄚˊ	gia
ㄍㄧㄚˇ	gia
ㄍㄧㄚˋ	gia
ㄍㄧㄚ˙	gia
ㄍㄧㄢ	gian
ㄍㄧㄢˉ	gian
ㄍㄧㄢˊ	gian
ㄍㄧㄢˇ	gian
ㄍㄧㄢˋ	gian
ㄍㄧㄢ˙	gian
ㄍㄧㄤ	giang
ㄍㄧㄤˉ	giang
ㄍㄧㄤˊ	giang
ㄍㄧㄤˇ	giang
ㄍㄧㄤˋ	giang
ㄍㄧㄤ˙	giang
ㄍㄧㄠ	giao
ㄍㄧㄠˉ	giao
ㄍㄧㄠˊ	giao
ㄍㄧㄠˇ	giao
ㄍㄧㄠˋ	giao
ㄍㄧㄠ˙	giao
ㄍㄧㄝ	gie
ㄍㄧㄝˉ	gie
ㄍㄧㄝˊ	gie
ㄍㄧㄝˇ	gie
ㄍㄧㄝˋ	gie
ㄍㄧㄝ˙	gie
ㄍㄧㄣ	gin
ㄍㄧㄣˉ	gin
ㄍㄧㄣˊ	gin
ㄍㄧㄣˇ	gin
ㄍㄧㄣˋ	gin
ㄍㄧㄣ˙	gin
ㄍㄧㄥ	ging
ㄍㄧㄥˉ	ging
ㄍㄧㄥˊ	ging
ㄍㄧㄥˇ	ging
ㄍㄧㄥˋ	ging
ㄍㄧㄥ˙	ging
ㄍㄩㄥ	giong
ㄍㄩㄥˉ	giong
ㄍㄩㄥˊ	giong
ㄍㄩㄥˇ	giong
ㄍㄩㄥˋ	giong
ㄍㄩㄥ˙	giong
ㄍㄧㄡ	giou
ㄍㄧㄡˉ	giou
ㄍㄧㄡˊ	giou
ㄍㄧㄡˇ	giou
ㄍㄧㄡˋ	giou
ㄍㄧㄡ˙	giou
ㄍㄧㄡ	giu
ㄍㄧㄡˉ	giu
ㄍㄧㄡˊ	giu
ㄍㄧㄡˇ	giu
ㄍㄧㄡˋ	giu
ㄍㄧㄡ˙	giu
ㄍㄩㄥ	giung
ㄍㄩㄥˉ	giung
ㄍㄩㄥˊ	giung
ㄍㄩㄥˇ	giung
ㄍㄩㄥˋ	giung
ㄍㄩㄥ˙	giung
ㄍㄛ	go
ㄍㄛˉ	go
ㄍㄛˊ	go
ㄍㄛˇ	go
ㄍㄛˋ	go
ㄍㄛ˙	go
ㄍㄨㄥ	gong
ㄍㄨㄥˉ	gong
ㄍㄨㄥˊ	gong
ㄍㄨㄥˇ	gong
ㄍㄨㄥˋ	gong
ㄍㄨㄥ˙	gong
ㄍㄡ	gou
ㄍㄡˉ	gou
ㄍㄡˊ	gou
ㄍㄡˇ	gou
ㄍㄡˋ	gou
ㄍㄡ˙	gou
ㄍㄨ	gu
ㄍㄨˉ	gu
ㄍㄨˊ	gu
ㄍㄨˇ	gu
ㄍㄨˋ	gu
ㄍㄨ˙	gu
ㄍㄨㄚ	gua
ㄍㄨㄚˉ	gua
ㄍㄨㄚˊ	gua
ㄍㄨㄚˇ	gua
ㄍㄨㄚˋ	gua
ㄍㄨㄚ˙	gua
ㄍㄨㄞ	guai
ㄍㄨㄞˉ	guai
ㄍㄨㄞˊ	guai
ㄍㄨㄞˇ	guai
ㄍㄨㄞˋ	guai
ㄍㄨㄞ˙	guai
ㄍㄨㄢ	guan
ㄍㄨㄢˉ	guan
ㄍㄨㄢˊ	guan
ㄍㄨㄢˇ	guan
ㄍㄨㄢˋ	guan
ㄍㄨㄢ˙	guan
ㄍㄨㄤ	guang
ㄍㄨㄤˉ	guang
ㄍㄨㄤˊ	guang
ㄍㄨㄤˇ	guang
ㄍㄨㄤˋ	guang
ㄍㄨㄤ˙	guang
ㄍㄨㄟ	gui
ㄍㄨㄟˉ	gui
ㄍㄨㄟˊ	gui
ㄍㄨㄟˇ	gui
ㄍㄨㄟˋ	gui
ㄍㄨㄟ˙	gui
ㄍㄨㄣ	gun
ㄍㄨㄣˉ	gun
ㄍㄨㄣˊ	gun
ㄍㄨㄣˇ	gun
ㄍㄨㄣˋ	gun
ㄍㄨㄣ˙	gun
ㄍㄨㄥ	gung
ㄍㄨㄥˉ	gung
ㄍㄨㄥˊ	gung
ㄍㄨㄥˇ	gung
ㄍㄨㄥˋ	gung
ㄍㄨㄥ˙	gung
ㄍㄨㄛ	guo
ㄍㄨㄛˉ	guo
ㄍㄨㄛˊ	guo
ㄍㄨㄛˇ	guo
ㄍㄨㄛˋ	guo
ㄍㄨㄛ˙	guo
ㄍㄩ	gv
ㄍㄩˉ	gv
ㄍㄩˊ	gv
ㄍㄩˇ	gv
ㄍㄩˋ	gv
ㄍㄩ˙	gv
ㄍㄩㄝ	gve
ㄍㄩㄝˉ	gve
ㄍㄩㄝˊ	gve
ㄍㄩㄝˇ	gve
ㄍㄩㄝˋ	gve
ㄍㄩㄝ˙	gve
ㄍㄩㄣ	gvn
ㄍㄩㄣˉ	gvn
ㄍㄩㄣˊ	gvn
ㄍㄩㄣˇ	gvn
ㄍㄩㄣˋ	gvn
ㄍㄩㄣ˙	gvn
ㄍㄩㄥ	gvng
ㄍㄩㄥˉ	gvng
ㄍㄩㄥˊ	gvng
ㄍㄩㄥˇ	gvng
ㄍㄩㄥˋ	gvng
ㄍㄩㄥ˙	gvng
ㄍㄩ	gyu
ㄍㄩˉ	gyu
ㄍㄩˊ	gyu
ㄍㄩˇ	gyu
ㄍㄩˋ	gyu
ㄍㄩ˙	gyu
ㄍㄩㄝ	gyue
ㄍㄩㄝˉ	gyue
ㄍㄩㄝˊ	gyue
ㄍㄩㄝˇ	gyue
ㄍㄩㄝˋ	gyue
ㄍㄩㄝ˙	gyue
ㄍㄩㄣ	gyun
ㄍㄩㄣˉ	gyun
ㄍㄩㄣˊ	gyun
ㄍㄩㄣˇ	gyun
ㄍㄩㄣˋ	gyun
ㄍㄩㄣ˙	gyun
ㄍㄩㄥ	gyung
ㄍㄩㄥˉ	gyung
ㄍㄩㄥˊ	gyung
ㄍㄩㄥˇ	gyung
ㄍㄩㄥˋ	gyung
ㄍㄩㄥ˙	gyung
ㄏㄚ	ha
ㄏㄚˉ	ha
ㄏㄚˊ	ha
ㄏㄚˇ	ha
ㄏㄚˋ	ha
ㄏㄚ˙	ha
ㄏㄞ	hai
ㄏㄞˉ	hai
ㄏㄞˊ	hai
ㄏㄞˇ	hai
ㄏㄞˋ	hai
ㄏㄞ˙	hai
ㄏㄢ	han
ㄏㄢˉ	han
ㄏㄢˊ	han
ㄏㄢˇ	han
ㄏㄢˋ	han
ㄏㄢ˙	han
ㄏㄤ	hang
ㄏㄤˉ	hang
ㄏㄤˊ	hang
ㄏㄤˇ	hang
ㄏㄤˋ	hang
ㄏㄤ˙	hang
ㄏㄠ	hao
ㄏㄠˉ	hao
ㄏㄠˊ	hao
ㄏㄠˇ	hao
ㄏㄠˋ	hao
ㄏㄠ˙	hao
ㄏㄜ	he
ㄏㄜˉ	he
ㄏㄜˊ	he
ㄏㄜˇ	he
ㄏㄜˋ	he
ㄏㄜ˙	he
ㄏㄟ	hei
ㄏㄟˉ	hei
ㄏㄟˊ	hei
ㄏㄟˇ	hei
ㄏㄟˋ	hei
ㄏㄟ˙	hei
ㄏㄣ	hen
ㄏㄣˉ	hen
ㄏㄣˊ	hen
ㄏㄣˇ	hen
ㄏㄣˋ	hen
ㄏㄣ˙	hen
ㄏㄥ	heng
ㄏㄥˉ	heng
ㄏㄥˊ	heng
ㄏㄥˇ	heng
ㄏㄥˋ	heng
ㄏㄥ˙	heng
ㄏㄦ	her
ㄏㄦˉ	her
ㄏㄦˊ	her
ㄏㄦˇ	her
ㄏㄦˋ	her
ㄏㄦ˙	her
ㄏㄧ	hi
ㄏㄧˉ	hi
ㄏㄧˊ	hi
ㄏㄧˇ	hi
ㄏㄧˋ	hi
ㄏㄧ˙	hi
ㄏㄧㄚ	hia
ㄏㄧㄚˉ	hia
ㄏㄧㄚˊ	hia
ㄏㄧㄚˇ	hia
ㄏㄧㄚˋ	hia
ㄏㄧㄚ˙	hia
ㄏㄧㄢ	hian
ㄏㄧㄢˉ	hian
ㄏㄧㄢˊ	hian
ㄏㄧㄢˇ	hian
ㄏㄧㄢˋ	hian
ㄏㄧㄢ˙	hian
ㄏㄧㄤ	hiang
ㄏㄧㄤˉ	hiang
ㄏㄧㄤˊ	hiang
ㄏㄧㄤˇ	hiang
ㄏㄧㄤˋ	hiang
ㄏㄧㄤ˙	hiang
ㄏㄧㄠ	hiao
ㄏㄧㄠˉ	hiao
ㄏㄧㄠˊ	hiao
ㄏㄧㄠˇ	hiao
ㄏㄧㄠˋ	hiao
ㄏㄧㄠ˙	hiao
ㄏㄧㄝ	hie
ㄏㄧㄝˉ	hie
ㄏㄧㄝˊ	hie
ㄏㄧㄝˇ	hie
ㄏㄧㄝˋ	hie
ㄏㄧㄝ˙	hie
ㄏㄧㄣ	hin
ㄏㄧㄣˉ	hin
ㄏㄧㄣˊ	hin
ㄏㄧㄣˇ	hin
ㄏㄧㄣˋ	hin
ㄏㄧㄣ˙	hin
ㄏㄧㄥ	hing
ㄏㄧㄥˉ	hing
ㄏㄧㄥˊ	hing
ㄏㄧㄥˇ	hing
ㄏㄧㄥˋ	hing
ㄏㄧㄥ˙	hing
ㄏㄩㄥ	hiong
ㄏㄩㄥˉ	hiong
ㄏㄩㄥˊ	hiong
ㄏㄩㄥˇ	hiong
ㄏㄩㄥˋ	hiong
ㄏㄩㄥ˙	hiong
ㄏㄧㄡ	hiou
ㄏㄧㄡˉ	hiou
ㄏㄧㄡˊ	hiou
ㄏㄧㄡˇ	hiou
ㄏㄧㄡˋ	hiou
ㄏㄧㄡ˙	hiou
ㄏㄧㄡ	hiu
ㄏㄧㄡˉ	hiu
ㄏㄧㄡˊ	hiu
ㄏㄧㄡˇ	hiu
ㄏㄧㄡˋ	hiu
ㄏㄧㄡ˙	hiu
ㄏㄩㄥ	hiung
ㄏㄩㄥˉ	hiung
ㄏㄩㄥˊ	hiung
ㄏㄩㄥˇ	hiung
ㄏㄩㄥˋ	hiung
ㄏㄩㄥ˙	hiung
ㄏㄛ	ho
ㄏㄛˉ	ho
ㄏㄛˊ	ho
ㄏㄛˇ	ho
ㄏㄛˋ	ho
ㄏㄛ˙	ho
ㄏㄨㄥ	hong
ㄏㄨㄥˉ	hong
ㄏㄨㄥˊ	hong
ㄏㄨㄥˇ	hong
ㄏㄨㄥˋ	hong
ㄏㄨㄥ˙	hong
ㄏㄡ	hou
ㄏㄡˉ	hou
ㄏㄡˊ	hou
ㄏㄡˇ	hou
ㄏㄡˋ	hou
ㄏㄡ˙	hou
ㄏㄨ	hu
ㄏㄨˉ	hu
ㄏㄨˊ	hu
ㄏㄨˇ	hu
ㄏㄨˋ	hu
ㄏㄨ˙	hu
ㄏㄨㄚ	hua
ㄏㄨㄚˉ	hua
ㄏㄨㄚˊ	hua
ㄏㄨㄚˇ	hua
ㄏㄨㄚˋ	hua
ㄏㄨㄚ˙	hua
ㄏㄨㄞ	huai
ㄏㄨㄞˉ	huai
ㄏㄨㄞˊ	huai
ㄏㄨㄞˇ	huai
ㄏㄨㄞˋ	huai
ㄏㄨㄞ˙	huai
ㄏㄨㄢ	huan
ㄏㄨㄢˉ	huan
ㄏㄨㄢˊ	huan
ㄏㄨㄢˇ	huan
ㄏㄨㄢˋ	huan
ㄏㄨㄢ˙	huan
ㄏㄨㄤ	huang
ㄏㄨㄤˉ	huang
ㄏㄨㄤˊ	huang
ㄏㄨㄤˇ	huang
ㄏㄨㄤˋ	huang
ㄏㄨㄤ˙	huang
ㄏㄨㄟ	hui
ㄏㄨㄟˉ	hui
ㄏㄨㄟˊ	hui
ㄏㄨㄟˇ	hui
ㄏㄨㄟˋ	hui
ㄏㄨㄟ˙	hui
ㄏㄨㄣ	hun
ㄏㄨㄣˉ	hun
ㄏㄨㄣˊ	hun
ㄏㄨㄣˇ	hun
ㄏㄨㄣˋ	hun
ㄏㄨㄣ˙	hun
ㄏㄨㄥ	hung
ㄏㄨㄥˉ	hung
ㄏㄨㄥˊ	hung
ㄏㄨㄥˇ	hung
ㄏㄨㄥˋ	hung
ㄏㄨㄥ˙	hung
ㄏㄨㄛ	huo
ㄏㄨㄛˉ	huo
ㄏㄨㄛˊ	huo
ㄏㄨㄛˇ	huo
ㄏㄨㄛˋ	huo
ㄏㄨㄛ˙	huo
ㄏㄩ	hv
ㄏㄩˉ	hv
ㄏㄩˊ	hv
ㄏㄩˇ	hv
ㄏㄩˋ	hv
ㄏㄩ˙	hv
ㄏㄩㄝ	hve
ㄏㄩㄝˉ	hve
ㄏㄩㄝˊ	hve
ㄏㄩㄝˇ	hve
ㄏㄩㄝˋ	hve
ㄏㄩㄝ˙	hve
ㄏㄩㄣ	hvn
ㄏㄩㄣˉ	hvn
ㄏㄩㄣˊ	hvn
ㄏㄩㄣˇ	hvn
ㄏㄩㄣˋ	hvn
ㄏㄩㄣ˙	hvn
ㄏㄩㄥ	hvng
ㄏㄩㄥˉ	hvng
ㄏㄩㄥˊ	hvng
ㄏㄩㄥˇ	hvng
ㄏㄩㄥˋ	hvng
ㄏㄩㄥ˙	hvng
ㄏㄩ	hyu
ㄏㄩˉ	hyu
ㄏㄩˊ	hyu
ㄏㄩˇ	hyu
ㄏㄩˋ	hyu
ㄏㄩ˙	hyu
ㄏㄩㄝ	hyue
ㄏㄩㄝˉ	hyue
ㄏㄩㄝˊ	hyue
ㄏㄩㄝˇ	hyue
ㄏㄩㄝˋ	hyue
ㄏㄩㄝ˙	hyue
ㄏㄩㄣ	hyun
ㄏㄩㄣˉ	hyun
ㄏㄩㄣˊ	hyun
ㄏㄩㄣˇ	hyun
ㄏㄩㄣˋ	hyun
ㄏㄩㄣ˙	hyun
ㄏㄩㄥ	hyung
ㄏㄩㄥˉ	hyung
ㄏㄩㄥˊ	hyung
ㄏㄩㄥˇ	hyung
ㄏㄩㄥˋ	hyung
ㄏㄩㄥ˙	hyung
ㄧ	i
ㄧˉ	i
ㄧˊ	i
ㄧˇ	i
ㄧˋ	i
ㄧ˙	i
ㄧㄚ	ia
ㄧㄚˉ	ia
ㄧㄚˊ	ia
ㄧㄚˇ	ia
ㄧㄚˋ	ia
ㄧㄚ˙	ia
ㄧㄢ	ian
ㄧㄢˉ	ian
ㄧㄢˊ	ian
ㄧㄢˇ	ian
ㄧㄢˋ	ian
ㄧㄢ˙	ian
ㄧㄤ	iang
ㄧㄤˉ	iang
ㄧㄤˊ	iang
ㄧㄤˇ	iang
ㄧㄤˋ	iang
ㄧㄤ˙	iang
ㄧㄠ	iao
ㄧㄠˉ	iao
ㄧㄠˊ	iao
ㄧㄠˇ	iao
ㄧㄠˋ	iao
ㄧㄠ˙	iao
ㄧㄝ	ie
ㄧㄝˉ	ie
ㄧㄝˊ	ie
ㄧㄝˇ	ie
ㄧㄝˋ	ie
ㄧㄝ˙	ie
ㄧㄣ	in
ㄧㄣˉ	in
ㄧㄣˊ	in
ㄧㄣˇ	in
ㄧㄣˋ	in
ㄧㄣ˙	in
ㄧㄥ	ing
ㄧㄥˉ	ing
ㄧㄥˊ	ing
ㄧㄥˇ	ing
ㄧㄥˋ	ing
ㄧㄥ˙	ing
ㄩㄥ	iong
ㄩㄥˉ	iong
ㄩㄥˊ	iong
ㄩㄥˇ	iong
ㄩㄥˋ	iong
ㄩㄥ˙	iong
ㄧㄡ	iou
ㄧㄡˉ	iou
ㄧㄡˊ	iou
ㄧㄡˇ	iou
ㄧㄡˋ	iou
ㄧㄡ˙	iou
ㄧㄡ	iu
ㄧㄡˉ	iu
ㄧㄡˊ	iu
ㄧㄡˇ	iu
ㄧㄡˋ	iu
ㄧㄡ˙	iu
ㄩㄥ	iung
ㄩㄥˉ	iung
ㄩㄥˊ	iung
ㄩㄥˇ	iung
ㄩㄥˋ	iung
ㄩㄥ˙	iung
ㄐㄚ	ja
ㄐㄚˉ	ja
ㄐㄚˊ	ja
ㄐㄚˇ	ja
ㄐㄚˋ	ja
ㄐㄚ˙	ja
ㄐㄞ	jai
ㄐㄞˉ	jai
ㄐㄞˊ	jai
ㄐㄞˇ	jai
ㄐㄞˋ	jai
ㄐㄞ˙	jai
ㄐㄢ	jan
ㄐㄢˉ	jan
ㄐㄢˊ	jan
ㄐㄢˇ	jan
ㄐㄢˋ	jan
ㄐㄢ˙	jan
ㄐㄤ	jang
ㄐㄤˉ	jang
ㄐㄤˊ	jang
ㄐㄤˇ	jang
ㄐㄤˋ	jang
ㄐㄤ˙	jang
ㄐㄠ	jao
ㄐㄠˉ	jao
ㄐㄠˊ	jao
ㄐㄠˇ	jao
ㄐㄠˋ	jao
ㄐㄠ˙	jao
ㄐㄜ	je
ㄐㄜˉ	je
ㄐㄜˊ	je
ㄐㄜˇ	je
ㄐㄜˋ	je
ㄐㄜ˙	je
ㄐㄟ	jei
ㄐㄟˉ	jei
ㄐㄟˊ	jei
ㄐㄟˇ	jei
ㄐㄟˋ	jei
ㄐㄟ˙	jei
ㄐㄣ	jen
ㄐㄣˉ	jen
ㄐㄣˊ	jen
ㄐㄣˇ	jen
ㄐㄣˋ	jen
ㄐㄣ˙	jen
ㄐㄥ	jeng
ㄐㄥˉ	jeng
ㄐㄥˊ	jeng
ㄐㄥˇ	jeng
ㄐㄥˋ	jeng
ㄐㄥ˙	jeng
ㄐㄦ	jer
ㄐㄦˉ	jer
ㄐㄦˊ	jer
ㄐㄦˇ	jer
ㄐㄦˋ	jer
ㄐㄦ˙	jer
ㄐㄧ	ji
ㄐㄧˉ	ji
ㄐㄧˊ	ji
ㄐㄧˇ	ji
ㄐㄧˋ	ji
ㄐㄧ˙	ji
ㄐㄧㄚ	jia
ㄐㄧㄚˉ	jia
ㄐㄧㄚˊ	jia
ㄐㄧㄚˇ	jia
ㄐㄧㄚˋ	jia
ㄐㄧㄚ˙	jia
ㄐㄧㄢ	jian
ㄐㄧㄢˉ	jian
ㄐㄧㄢˊ	jian
ㄐㄧㄢˇ	jian
ㄐㄧㄢˋ	jian
ㄐㄧㄢ˙	jian
ㄐㄧㄤ	jiang
ㄐㄧㄤˉ	jiang
ㄐㄧㄤˊ	jiang
ㄐㄧㄤˇ	jiang
ㄐㄧㄤˋ	jiang
ㄐㄧㄤ˙	jiang
ㄐㄧㄠ	jiao
ㄐㄧㄠˉ	jiao
ㄐㄧㄠˊ	jiao
ㄐㄧㄠˇ	jiao
ㄐㄧㄠˋ	jiao
ㄐㄧㄠ˙	jiao
ㄐㄧㄝ	jie
ㄐㄧㄝˉ	jie
ㄐㄧㄝˊ	jie
ㄐㄧㄝˇ	jie
ㄐㄧㄝˋ	jie
ㄐㄧㄝ˙	jie
ㄐㄧㄣ	jin
ㄐㄧㄣˉ	jin
ㄐㄧㄣˊ	jin
ㄐㄧㄣˇ	jin
ㄐㄧㄣˋ	jin
ㄐㄧㄣ˙	jin
ㄐㄧㄥ	jing
ㄐㄧㄥˉ	jing
ㄐㄧㄥˊ	jing
ㄐㄧㄥˇ	jing
ㄐㄧㄥˋ	jing
ㄐㄧㄥ˙	jing
ㄐㄩㄥ	jiong
ㄐㄩㄥˉ	jiong
ㄐㄩㄥˊ	jiong
ㄐㄩㄥˇ	jiong
ㄐㄩㄥˋ	jiong
ㄐㄩㄥ˙	jiong
ㄐㄧㄡ	jiou
ㄐㄧㄡˉ	jiou
ㄐㄧㄡˊ	jiou
ㄐㄧㄡˇ	jiou
ㄐㄧㄡˋ	jiou
ㄐㄧㄡ˙	jiou
ㄐㄧㄡ	jiu
ㄐㄧㄡˉ	jiu
ㄐㄧㄡˊ	jiu
ㄐㄧㄡˇ	jiu
ㄐㄧㄡˋ	jiu
ㄐㄧㄡ˙	jiu
ㄐㄩㄥ	jiung
ㄐㄩㄥˉ	jiung
ㄐㄩㄥˊ	jiung
ㄐㄩㄥˇ	jiung
ㄐㄩㄥˋ	jiung
ㄐㄩㄥ˙	jiung
ㄐㄛ	jo
ㄐㄛˉ	jo
ㄐㄛˊ	jo
ㄐㄛˇ	jo
ㄐㄛˋ	jo
ㄐㄛ˙	jo
ㄐㄨㄥ	jong
ㄐㄨㄥˉ	jong
ㄐㄨㄥˊ	jong
ㄐㄨㄥˇ	jong
ㄐㄨㄥˋ	jong
ㄐㄨㄥ˙	jong
ㄐㄡ	jou
ㄐㄡˉ	jou
ㄐㄡˊ	jou
ㄐㄡˇ	jou
ㄐㄡˋ	jou
ㄐㄡ˙	jou
ㄐㄨ	ju
ㄐㄨˉ	ju
ㄐㄨˊ	ju
ㄐㄨˇ	ju
ㄐㄨˋ	ju
ㄐㄨ˙	ju
ㄐㄨㄚ	jua
ㄐㄨㄚˉ	jua
ㄐㄨㄚˊ	jua
ㄐㄨㄚˇ	jua
ㄐㄨㄚˋ	jua
ㄐㄨㄚ˙	jua
ㄐㄨㄞ	juai
ㄐㄨㄞˉ	juai
ㄐㄨㄞˊ	juai
ㄐㄨㄞˇ	juai
ㄐㄨㄞˋ	juai
ㄐㄨㄞ˙	juai
ㄐㄨㄢ	juan
ㄐㄨㄢˉ	juan
ㄐㄨㄢˊ	juan
ㄐㄨㄢˇ	juan
ㄐㄨㄢˋ	juan
ㄐㄨㄢ˙	juan
ㄐㄨㄤ	juang
ㄐㄨㄤˉ	juang
ㄐㄨㄤˊ	juang
ㄐㄨㄤˇ	juang
ㄐㄨㄤˋ	juang
ㄐㄨㄤ˙	juang
ㄐㄩㄝ	jue
ㄐㄩㄝˉ	jue
ㄐㄩㄝˊ	jue
ㄐㄩㄝˇ	jue
ㄐㄩㄝˋ	jue
ㄐㄩㄝ˙	jue
ㄐㄨㄟ	jui
ㄐㄨㄟˉ	jui
ㄐㄨㄟˊ	jui
ㄐㄨㄟˇ	jui
ㄐㄨㄟˋ	jui
ㄐㄨㄟ˙	jui
ㄐㄨㄣ	jun
ㄐㄨㄣˉ	jun
ㄐㄨㄣˊ	jun
ㄐㄨㄣˇ	jun
ㄐㄨㄣˋ	jun
ㄐㄨㄣ˙	jun
ㄐㄨㄥ	jung
ㄐㄨㄥˉ	jung
ㄐㄨㄥˊ	jung
ㄐㄨㄥˇ	jung
ㄐㄨㄥˋ	jung
ㄐㄨㄥ˙	jung
ㄐㄨㄛ	juo
ㄐㄨㄛˉ	juo
ㄐㄨㄛˊ	juo
ㄐㄨㄛˇ	juo
ㄐㄨㄛˋ	juo
ㄐㄨㄛ˙	juo
ㄐㄩ	jv
ㄐㄩˉ	jv
ㄐㄩˊ	jv
ㄐㄩˇ	jv
ㄐㄩˋ	jv
ㄐㄩ˙	jv
ㄐㄩㄝ	jve
ㄐㄩㄝˉ	jve
ㄐㄩㄝˊ	jve
ㄐㄩㄝˇ	jve
ㄐㄩㄝˋ	jve
ㄐㄩㄝ˙	jve
ㄐㄩㄣ	jvn
ㄐㄩㄣˉ	jvn
ㄐㄩㄣˊ	jvn
ㄐㄩㄣˇ	jvn
ㄐㄩㄣˋ	jvn
ㄐㄩㄣ˙	jvn
ㄐㄩㄥ	jvng
ㄐㄩㄥˉ	jvng
ㄐㄩㄥˊ	jvng
ㄐㄩㄥˇ	jvng
ㄐㄩㄥˋ	jvng
ㄐㄩㄥ˙	jvng
ㄐㄩ	jyu
ㄐㄩˉ	jyu
ㄐㄩˊ	jyu
ㄐㄩˇ	jyu
ㄐㄩˋ	jyu
ㄐㄩ˙	jyu
ㄐㄩㄝ	jyue
ㄐㄩㄝˉ	jyue
ㄐㄩㄝˊ	jyue
ㄐㄩㄝˇ	jyue
ㄐㄩㄝˋ	jyue
ㄐㄩㄝ˙	jyue
ㄐㄩㄣ	jyun
ㄐㄩㄣˉ	jyun
ㄐㄩㄣˊ	jyun
ㄐㄩㄣˇ	jyun
ㄐㄩㄣˋ	jyun
ㄐㄩㄣ˙	jyun
ㄐㄩㄥ	jyung
ㄐㄩㄥˉ	jyung
ㄐㄩㄥˊ	jyung
ㄐㄩㄥˇ	jyung
ㄐㄩㄥˋ	jyung
ㄐㄩㄥ˙	jyung
ㄎㄚ	ka
ㄎㄚˉ	ka
ㄎㄚˊ	ka
ㄎㄚˇ	ka
ㄎㄚˋ	ka
ㄎㄚ˙	ka
ㄎㄞ	kai
ㄎㄞˉ	kai
ㄎㄞˊ	kai
ㄎㄞˇ	kai
ㄎㄞˋ	kai
ㄎㄞ˙	kai
ㄎㄢ	kan
ㄎㄢˉ	kan
ㄎㄢˊ	kan
ㄎㄢˇ	kan
ㄎㄢˋ	kan
ㄎㄢ˙	kan
ㄎㄤ	kang
ㄎㄤˉ	kang
ㄎㄤˊ	kang
ㄎㄤˇ	kang
ㄎㄤˋ	kang
ㄎㄤ˙	kang
ㄎㄠ	kao
ㄎㄠˉ	kao
ㄎㄠˊ	kao
ㄎㄠˇ	kao
ㄎㄠˋ	kao
ㄎㄠ˙	kao
ㄎㄜ	ke
ㄎㄜˉ	ke
ㄎㄜˊ	ke
ㄎㄜˇ	ke
ㄎㄜˋ	ke
ㄎㄜ˙	ke
ㄎㄟ	kei
ㄎㄟˉ	kei
ㄎㄟˊ	kei
ㄎㄟˇ	kei
ㄎㄟˋ	kei
ㄎㄟ˙	kei
ㄎㄣ	ken
ㄎㄣˉ	ken
ㄎㄣˊ	ken
ㄎㄣˇ	ken
ㄎㄣˋ	ken
ㄎㄣ˙	ken
ㄎㄥ	keng
ㄎㄥˉ	keng
ㄎㄥˊ	keng
ㄎㄥˇ	keng
ㄎㄥˋ	keng
ㄎㄥ˙	keng
ㄎㄦ	ker
ㄎㄦˉ	ker
ㄎㄦˊ	ker
ㄎㄦˇ	ker
ㄎㄦˋ	ker
ㄎㄦ˙	ker
ㄎㄧ	ki
ㄎㄧˉ	ki
ㄎㄧˊ	ki
ㄎㄧˇ	ki
ㄎㄧˋ	ki
ㄎㄧ˙	ki
ㄎㄧㄚ	kia
ㄎㄧㄚˉ	kia
ㄎㄧㄚˊ	kia
ㄎㄧㄚˇ	kia
ㄎㄧㄚˋ	kia
ㄎㄧㄚ˙	kia
ㄎㄧㄢ	kian
ㄎㄧㄢˉ	kian
ㄎㄧㄢˊ	kian
ㄎㄧㄢˇ	kian
ㄎㄧㄢˋ	kian
ㄎㄧㄢ˙	kian
ㄎㄧㄤ	kiang
ㄎㄧㄤˉ	kiang
ㄎㄧㄤˊ	kiang
ㄎㄧㄤˇ	kiang
ㄎㄧㄤˋ	kiang
ㄎㄧㄤ˙	kiang
ㄎㄧㄠ	kiao
ㄎㄧㄠˉ	kiao
ㄎㄧㄠˊ	kiao
ㄎㄧㄠˇ	kiao
ㄎㄧㄠˋ	kiao
ㄎㄧㄠ˙	kiao
ㄎㄧㄝ	kie
ㄎㄧㄝˉ	kie
ㄎㄧㄝˊ	kie
ㄎㄧㄝˇ	kie
ㄎㄧㄝˋ	kie
ㄎㄧㄝ˙	kie
ㄎㄧㄣ	kin
ㄎㄧㄣˉ	kin
ㄎㄧㄣˊ	kin
ㄎㄧㄣˇ	kin
ㄎㄧㄣˋ	kin
ㄎㄧㄣ˙	kin
ㄎㄧㄥ	king
ㄎㄧㄥˉ	king
ㄎㄧㄥˊ	king
ㄎㄧㄥˇ	king
ㄎㄧㄥˋ	king
ㄎㄧㄥ˙	king
ㄎㄩㄥ	kiong
ㄎㄩㄥˉ	kiong
ㄎㄩㄥˊ	kiong
ㄎㄩㄥˇ	kiong
ㄎㄩㄥˋ	kiong
ㄎㄩㄥ˙	kiong
ㄎㄧㄡ	kiou
ㄎㄧㄡˉ	kiou
ㄎㄧㄡˊ	kiou
ㄎㄧㄡˇ	kiou
ㄎㄧㄡˋ	kiou
ㄎㄧㄡ˙	kiou
ㄎㄧㄡ	kiu
ㄎㄧㄡˉ	kiu
ㄎㄧㄡˊ	kiu
ㄎㄧㄡˇ	kiu
ㄎㄧㄡˋ	kiu
ㄎㄧㄡ˙	kiu
ㄎㄩㄥ	kiung
ㄎㄩㄥˉ	kiung
ㄎㄩㄥˊ	kiung
ㄎㄩㄥˇ	kiung
ㄎㄩㄥˋ	kiung
ㄎㄩㄥ˙	kiung
ㄎㄛ	ko
ㄎㄛˉ	ko
ㄎㄛˊ	ko
ㄎㄛˇ	ko
ㄎㄛˋ	ko
ㄎㄛ˙	ko
ㄎㄨㄥ	kong
ㄎㄨㄥˉ	kong
ㄎㄨㄥˊ	kong
ㄎㄨㄥˇ	kong
ㄎㄨㄥˋ	kong
ㄎㄨㄥ˙	kong
ㄎㄡ	kou
ㄎㄡˉ	kou
ㄎㄡˊ	kou
ㄎㄡˇ	kou
ㄎㄡˋ	kou
ㄎㄡ˙	kou
ㄎㄨ	ku
ㄎㄨˉ	ku
ㄎㄨˊ	ku
ㄎㄨˇ	ku
ㄎㄨˋ	ku
ㄎㄨ˙	ku
ㄎㄨㄚ	kua
ㄎㄨㄚˉ	kua
ㄎㄨㄚˊ	kua
ㄎㄨㄚˇ	kua
ㄎㄨㄚˋ	kua
ㄎㄨㄚ˙	kua
ㄎㄨㄞ	kuai
ㄎㄨㄞˉ	kuai
ㄎㄨㄞˊ	kuai
ㄎㄨㄞˇ	kuai
ㄎㄨㄞˋ	kuai
ㄎㄨㄞ˙	kuai
ㄎㄨㄢ	kuan
ㄎㄨㄢˉ	kuan
ㄎㄨㄢˊ	kuan
ㄎㄨㄢˇ	kuan
ㄎㄨㄢˋ	kuan
ㄎㄨㄢ˙	kuan
ㄎㄨㄤ	kuang
ㄎㄨㄤˉ	kuang
ㄎㄨㄤˊ	kuang
ㄎㄨㄤˇ	kuang
ㄎㄨㄤˋ	kuang
ㄎㄨㄤ˙	kuang
ㄎㄨㄟ	kui
ㄎㄨㄟˉ	kui
ㄎㄨㄟˊ	kui
ㄎㄨㄟˇ	kui
ㄎㄨㄟˋ	kui
ㄎㄨㄟ˙	kui
ㄎㄨㄣ	kun
ㄎㄨㄣˉ	kun
ㄎㄨㄣˊ	kun
ㄎㄨㄣˇ	kun
ㄎㄨㄣˋ	kun
ㄎㄨㄣ˙	kun
ㄎㄨㄥ	kung
ㄎㄨㄥˉ	kung
ㄎㄨㄥˊ	kung
ㄎㄨㄥˇ	kung
ㄎㄨㄥˋ	kung
ㄎㄨㄥ˙	kung
ㄎㄨㄛ	kuo
ㄎㄨㄛˉ	kuo
ㄎㄨㄛˊ	kuo
ㄎㄨㄛˇ	kuo
ㄎㄨㄛˋ	kuo
ㄎㄨㄛ˙	kuo
ㄎㄩ	kv
ㄎㄩˉ	kv
ㄎㄩˊ	kv
ㄎㄩˇ	kv
ㄎㄩˋ	kv
ㄎㄩ˙	kv
ㄎㄩㄝ	kve
ㄎㄩㄝˉ	kve
ㄎㄩㄝˊ	kve
ㄎㄩㄝˇ	kve
ㄎㄩㄝˋ	kve
ㄎㄩㄝ˙	kve
ㄎㄩㄣ	kvn
ㄎㄩㄣˉ	kvn
ㄎㄩㄣˊ	kvn
ㄎㄩㄣˇ	kvn
ㄎㄩㄣˋ	kvn
ㄎㄩㄣ˙	kvn
ㄎㄩㄥ	kvng
ㄎㄩㄥˉ	kvng
ㄎㄩㄥˊ	kvng
ㄎㄩㄥˇ	kvng
ㄎㄩㄥˋ	kvng
ㄎㄩㄥ˙	kvng
ㄎㄩ	kyu
ㄎㄩˉ	kyu
ㄎㄩˊ	kyu
ㄎㄩˇ	kyu
ㄎㄩˋ	kyu
ㄎㄩ˙	kyu
ㄎㄩㄝ	kyue
ㄎㄩㄝˉ	kyue
ㄎㄩㄝˊ	kyue
ㄎㄩㄝˇ	kyue
ㄎㄩㄝˋ	kyue
ㄎㄩㄝ˙	kyue
ㄎㄩㄣ	kyun
ㄎㄩㄣˉ	kyun
ㄎㄩㄣˊ	kyun
ㄎㄩㄣˇ	kyun
ㄎㄩㄣˋ	kyun
ㄎㄩㄣ˙	kyun
ㄎㄩㄥ	kyung
ㄎㄩㄥˉ	kyung
ㄎㄩㄥˊ	kyung
ㄎㄩㄥˇ	kyung
ㄎㄩㄥˋ	kyung
ㄎㄩㄥ˙	kyung
ㄌㄚ	la
ㄌㄚˉ	la
ㄌㄚˊ	la
ㄌㄚˇ	la
ㄌㄚˋ	la
ㄌㄚ˙	la
ㄌㄞ	lai
ㄌㄞˉ	lai
ㄌㄞˊ	lai
ㄌㄞˇ	lai
ㄌㄞˋ	lai
ㄌㄞ˙	lai
ㄌㄢ	lan
ㄌㄢˉ	lan
ㄌㄢˊ	lan
ㄌㄢˇ	lan
ㄌㄢˋ	lan
ㄌㄢ˙	lan
ㄌㄤ	lang
ㄌㄤˉ	lang
ㄌㄤˊ	lang
ㄌㄤˇ	lang
ㄌㄤˋ	lang
ㄌㄤ˙	lang
ㄌㄠ	lao
ㄌㄠˉ	lao
ㄌㄠˊ	lao
ㄌㄠˇ	lao
ㄌㄠˋ	lao
ㄌㄠ˙	lao
ㄌㄜ	le
ㄌㄜˉ	le
ㄌㄜˊ	le
ㄌㄜˇ	le
ㄌㄜˋ	le
ㄌㄜ˙	le
ㄌㄟ	lei
ㄌㄟˉ	lei
ㄌㄟˊ	lei
ㄌㄟˇ	lei
ㄌㄟˋ	lei
ㄌㄟ˙	lei
ㄌㄣ	len
ㄌㄣˉ	len
ㄌㄣˊ	len
ㄌㄣˇ	len
ㄌㄣˋ	len
ㄌㄣ˙	len
ㄌㄥ	leng
ㄌㄥˉ	leng
ㄌㄥˊ	leng
ㄌㄥˇ	leng
ㄌㄥˋ	leng
ㄌㄥ˙	leng
ㄌㄦ	ler
ㄌㄦˉ	ler
ㄌㄦˊ	ler
ㄌㄦˇ	ler
ㄌㄦˋ	ler
ㄌㄦ˙	ler
ㄌㄧ	li
ㄌㄧˉ	li
ㄌㄧˊ	li
ㄌㄧˇ	li
ㄌㄧˋ	li
ㄌㄧ˙	li
ㄌㄧㄚ	lia
ㄌㄧㄚˉ	lia
ㄌㄧㄚˊ	lia
ㄌㄧㄚˇ	lia
ㄌㄧㄚˋ	lia
ㄌㄧㄚ˙	lia
ㄌㄧㄢ	lian
ㄌㄧㄢˉ	lian
ㄌㄧㄢˊ	lian
ㄌㄧㄢˇ	lian
ㄌㄧㄢˋ	lian
ㄌㄧㄢ˙	lian
ㄌㄧㄤ	liang
ㄌㄧㄤˉ	liang
ㄌㄧㄤˊ	liang
ㄌㄧㄤˇ	liang
ㄌㄧㄤˋ	liang
ㄌㄧㄤ˙	liang
ㄌㄧㄠ	liao
ㄌㄧㄠˉ	liao
ㄌㄧㄠˊ	liao
ㄌㄧㄠˇ	liao
ㄌㄧㄠˋ	liao
ㄌㄧㄠ˙	liao
ㄌㄧㄝ	lie
ㄌㄧㄝˉ	lie
ㄌㄧㄝˊ	lie
ㄌㄧㄝˇ	lie
ㄌㄧㄝˋ	lie
ㄌㄧㄝ˙	lie
ㄌㄧㄣ	lin
ㄌㄧㄣˉ	lin
ㄌㄧㄣˊ	lin
ㄌㄧㄣˇ	lin
ㄌㄧㄣˋ	lin
ㄌㄧㄣ˙	lin
ㄌㄧㄥ	ling
ㄌㄧㄥˉ	ling
ㄌㄧㄥˊ	ling
ㄌㄧㄥˇ	ling
ㄌㄧㄥˋ	ling
ㄌㄧㄥ˙	ling
ㄌㄩㄥ	liong
ㄌㄩㄥˉ	liong
ㄌㄩㄥˊ	liong
ㄌㄩㄥˇ	liong
ㄌㄩㄥˋ	liong
ㄌㄩㄥ˙	liong
ㄌㄧㄡ	liou
ㄌㄧㄡˉ	liou
ㄌㄧㄡˊ	liou
ㄌㄧㄡˇ	liou
ㄌㄧㄡˋ	liou
ㄌㄧㄡ˙	liou
ㄌㄧㄡ	liu
ㄌㄧㄡˉ	liu
ㄌㄧㄡˊ	liu
ㄌㄧㄡˇ	liu
ㄌㄧㄡˋ	liu
ㄌㄧㄡ˙	liu
ㄌㄩㄥ	liung
ㄌㄩㄥˉ	liung
ㄌㄩㄥˊ	liung
ㄌㄩㄥˇ	liung
ㄌㄩㄥˋ	liung
ㄌㄩㄥ˙	liung
ㄌㄛ	lo
ㄌㄛˉ	lo
ㄌㄛˊ	lo
ㄌㄛˇ	lo
ㄌㄛˋ	lo
ㄌㄛ˙	lo
ㄌㄨㄥ	long
ㄌㄨㄥˉ	long
ㄌㄨㄥˊ	long
ㄌㄨㄥˇ	long
ㄌㄨㄥˋ	long
ㄌㄨㄥ˙	long
ㄌㄡ	lou
ㄌㄡˉ	lou
ㄌㄡˊ	lou
ㄌㄡˇ	lou
ㄌㄡˋ	lou
ㄌㄡ˙	lou
ㄌㄨ	lu
ㄌㄨˉ	lu
ㄌㄨˊ	lu
ㄌㄨˇ	lu
ㄌㄨˋ	lu
ㄌㄨ˙	lu
ㄌㄨㄚ	lua
ㄌㄨㄚˉ	lua
ㄌㄨㄚˊ	lua
ㄌㄨㄚˇ	lua
ㄌㄨㄚˋ	lua
ㄌㄨㄚ˙	lua
ㄌㄨㄞ	luai
ㄌㄨㄞˉ	luai
ㄌㄨㄞˊ	luai
ㄌㄨㄞˇ	luai
ㄌㄨㄞˋ	luai
ㄌㄨㄞ˙	luai
ㄌㄨㄢ	luan
ㄌㄨㄢˉ	luan
ㄌㄨㄢˊ	luan
ㄌㄨㄢˇ	luan
ㄌㄨㄢˋ	luan
ㄌㄨㄢ˙	luan
ㄌㄨㄤ	luang
ㄌㄨㄤˉ	luang
ㄌㄨㄤˊ	luang
ㄌㄨㄤˇ	luang
ㄌㄨㄤˋ	luang
ㄌㄨㄤ˙	luang
ㄌㄩㄝ	lue
ㄌㄩㄝˉ	lue
ㄌㄩㄝˊ	lue
ㄌㄩㄝˇ	lue
ㄌㄩㄝˋ	lue
ㄌㄩㄝ˙	lue
ㄌㄨㄟ	lui
ㄌㄨㄟˉ	lui
ㄌㄨㄟˊ	lui
ㄌㄨㄟˇ	lui
ㄌㄨㄟˋ	lui
ㄌㄨㄟ˙	lui
ㄌㄨㄣ	lun
ㄌㄨㄣˉ	lun
ㄌㄨㄣˊ	lun
ㄌㄨㄣˇ	lun
ㄌㄨㄣˋ	lun
ㄌㄨㄣ˙	lun
ㄌㄨㄥ	lung
ㄌㄨㄥˉ	lung
ㄌㄨㄥˊ	lung
ㄌㄨㄥˇ	lung
ㄌㄨㄥˋ	lung
ㄌㄨㄥ˙	lung
ㄌㄨㄛ	luo
ㄌㄨㄛˉ	luo
ㄌㄨㄛˊ	luo
ㄌㄨㄛˇ	luo
ㄌㄨㄛˋ	luo
ㄌㄨㄛ˙	luo
ㄌㄩ	lv
ㄌㄩˉ	lv
ㄌㄩˊ	lv
ㄌㄩˇ	lv
ㄌㄩˋ	lv
ㄌㄩ˙	lv
ㄌㄩㄝ	lve
ㄌㄩㄝˉ	lve
ㄌㄩㄝˊ	lve
ㄌㄩㄝˇ	lve
ㄌㄩㄝˋ	lve
ㄌㄩㄝ˙	lve
ㄌㄩㄣ	lvn
ㄌㄩㄣˉ	lvn
ㄌㄩㄣˊ	lvn
ㄌㄩㄣˇ	lvn
ㄌㄩㄣˋ	lvn
ㄌㄩㄣ˙	lvn
ㄌㄩㄥ	lvng
ㄌㄩㄥˉ	lvng
ㄌㄩㄥˊ	lvng
ㄌㄩㄥˇ	lvng
ㄌㄩㄥˋ	lvng
ㄌㄩㄥ˙	lvng
ㄌㄩ	lyu
ㄌㄩˉ	lyu
ㄌㄩˊ	lyu
ㄌㄩˇ	lyu
ㄌㄩˋ	lyu
ㄌㄩ˙	lyu
ㄌㄩㄝ	lyue
ㄌㄩㄝˉ	lyue
ㄌㄩㄝˊ	lyue
ㄌㄩㄝˇ	lyue
ㄌㄩㄝˋ	lyue
ㄌㄩㄝ˙	lyue
ㄌㄩㄣ	lyun
ㄌㄩㄣˉ	lyun
ㄌㄩㄣˊ	lyun
ㄌㄩㄣˇ	lyun
ㄌㄩㄣˋ	lyun
ㄌㄩㄣ˙	lyun
ㄌㄩㄥ	lyung
ㄌㄩㄥˉ	lyung
ㄌㄩㄥˊ	lyung
ㄌㄩㄥˇ	lyung
ㄌㄩㄥˋ	lyung
ㄌㄩㄥ˙	lyung
ㄇㄚ	ma
ㄇㄚˉ	ma
ㄇㄚˊ	ma
ㄇㄚˇ	ma
ㄇㄚˋ	ma
ㄇㄚ˙	ma
ㄇㄞ	mai
ㄇㄞˉ	mai
ㄇㄞˊ	mai
ㄇㄞˇ	mai
ㄇㄞˋ	mai
ㄇㄞ˙	mai
ㄇㄢ	man
ㄇㄢˉ	man
ㄇㄢˊ	man
ㄇㄢˇ	man
ㄇㄢˋ	man
ㄇㄢ˙	man
ㄇㄤ	mang
ㄇㄤˉ	mang
ㄇㄤˊ	mang
ㄇㄤˇ	mang
ㄇㄤˋ	mang
ㄇㄤ˙	mang
ㄇㄠ	mao
ㄇㄠˉ	mao
ㄇㄠˊ	mao
ㄇㄠˇ	mao
ㄇㄠˋ	mao
ㄇㄠ˙	mao
ㄇㄜ	me
ㄇㄜˉ	me
ㄇㄜˊ	me
ㄇㄜˇ	me
ㄇㄜˋ	me
ㄇㄜ˙	me
ㄇㄟ	mei
ㄇㄟˉ	mei
ㄇㄟˊ	mei
ㄇㄟˇ	mei
ㄇㄟˋ	mei
ㄇㄟ˙	mei
ㄇㄣ	men
ㄇㄣˉ	men
ㄇㄣˊ	men
ㄇㄣˇ	men
ㄇㄣˋ	men
ㄇㄣ˙	men
ㄇㄥ	meng
ㄇㄥˉ	meng
ㄇㄥˊ	meng
ㄇㄥˇ	meng
ㄇㄥˋ	meng
ㄇㄥ˙	meng
ㄇㄦ	mer
ㄇㄦˉ	mer
ㄇㄦˊ	mer
ㄇㄦˇ	mer
ㄇㄦˋ	mer
ㄇㄦ˙	mer
ㄇㄧ	mi
ㄇㄧˉ	mi
ㄇㄧˊ	mi
ㄇㄧˇ	mi
ㄇㄧˋ	mi
ㄇㄧ˙	mi
ㄇㄧㄚ	mia
ㄇㄧㄚˉ	mia
ㄇㄧㄚˊ	mia
ㄇㄧㄚˇ	mia
ㄇㄧㄚˋ	mia
ㄇㄧㄚ˙	mia
ㄇㄧㄢ	mian
ㄇㄧㄢˉ	mian
ㄇㄧㄢˊ	mian
ㄇㄧㄢˇ	mian
ㄇㄧㄢˋ	mian
ㄇㄧㄢ˙	mian
ㄇㄧㄤ	miang
ㄇㄧㄤˉ	miang
ㄇㄧㄤˊ	miang
ㄇㄧㄤˇ	miang
ㄇㄧㄤˋ	miang
ㄇㄧㄤ˙	miang
ㄇㄧㄠ	miao
ㄇㄧㄠˉ	miao
ㄇㄧㄠˊ	miao
ㄇㄧㄠˇ	miao
ㄇㄧㄠˋ	miao
ㄇㄧㄠ˙	miao
ㄇㄧㄝ	mie
ㄇㄧㄝˉ	mie
ㄇㄧㄝˊ	mie
ㄇㄧㄝˇ	mie
ㄇㄧㄝˋ	mie
ㄇㄧㄝ˙	mie
ㄇㄧㄣ	min
ㄇㄧㄣˉ	min
ㄇㄧㄣˊ	min
ㄇㄧㄣˇ	min
ㄇㄧㄣˋ	min
ㄇㄧㄣ˙	min
ㄇㄧㄥ	ming
ㄇㄧㄥˉ	ming
ㄇㄧㄥˊ	ming
ㄇㄧㄥˇ	ming
ㄇㄧㄥˋ	ming
ㄇㄧㄥ˙	ming
ㄇㄩㄥ	miong
ㄇㄩㄥˉ	miong
ㄇㄩㄥˊ	miong
ㄇㄩㄥˇ	miong
ㄇㄩㄥˋ	miong
ㄇㄩㄥ˙	miong
ㄇㄧㄡ	miou
ㄇㄧㄡˉ	miou
ㄇㄧㄡˊ	miou
ㄇㄧㄡˇ	miou
ㄇㄧㄡˋ	miou
ㄇㄧㄡ˙	miou
ㄇㄧㄡ	miu
ㄇㄧㄡˉ	miu
ㄇㄧㄡˊ	miu
ㄇㄧㄡˇ	miu
ㄇㄧㄡˋ	miu
ㄇㄧㄡ˙	miu
ㄇㄩㄥ	miung
ㄇㄩㄥˉ	miung
ㄇㄩㄥˊ	miung
ㄇㄩㄥˇ	miung
ㄇㄩㄥˋ	miung
ㄇㄩㄥ˙	miung
ㄇㄛ	mo
ㄇㄛˉ	mo
ㄇㄛˊ	mo
ㄇㄛˇ	mo
ㄇㄛˋ	mo
ㄇㄛ˙	mo
ㄇㄨㄥ	mong
ㄇㄨㄥˉ	mong
ㄇㄨㄥˊ	mong
ㄇㄨㄥˇ	mong
ㄇㄨㄥˋ	mong
ㄇㄨㄥ˙	mong
ㄇㄡ	mou
ㄇㄡˉ	mou
ㄇㄡˊ	mou
ㄇㄡˇ	mou
ㄇㄡˋ	mou
ㄇㄡ˙	mou
ㄇㄨ	mu
ㄇㄨˉ	mu
ㄇㄨˊ	mu
ㄇㄨˇ	mu
ㄇㄨˋ	mu
ㄇㄨ˙	mu
ㄇㄨㄚ	mua
ㄇㄨㄚˉ	mua
ㄇㄨㄚˊ	mua
ㄇㄨㄚˇ	mua
ㄇㄨㄚˋ	mua
ㄇㄨㄚ˙	mua
ㄇㄨㄞ	muai
ㄇㄨㄞˉ	muai
ㄇㄨㄞˊ	muai
ㄇㄨㄞˇ	muai
ㄇㄨㄞˋ	muai
ㄇㄨㄞ˙	muai
ㄇㄨㄢ	muan
ㄇㄨㄢˉ	muan
ㄇㄨㄢˊ	muan
ㄇㄨㄢˇ	muan
ㄇㄨㄢˋ	muan
ㄇㄨㄢ˙	muan
ㄇㄨㄤ	muang
ㄇㄨㄤˉ	muang
ㄇㄨㄤˊ	muang
ㄇㄨㄤˇ	muang
ㄇㄨㄤˋ	muang
ㄇㄨㄤ˙	muang
ㄇㄨㄟ	mui
ㄇㄨㄟˉ	mui
ㄇㄨㄟˊ	mui
ㄇㄨㄟˇ	mui
ㄇㄨㄟˋ	mui
ㄇㄨㄟ˙	mui
ㄇㄨㄣ	mun
ㄇㄨㄣˉ	mun
ㄇㄨㄣˊ	mun
ㄇㄨㄣˇ	mun
ㄇㄨㄣˋ	mun
ㄇㄨㄣ˙	mun
ㄇㄨㄥ	mung
ㄇㄨㄥˉ	mung
ㄇㄨㄥˊ	mung
ㄇㄨㄥˇ	mung
ㄇㄨㄥˋ	mung
ㄇㄨㄥ˙	mung
ㄇㄨㄛ	muo
ㄇㄨㄛˉ	muo
ㄇㄨㄛˊ	muo
ㄇㄨㄛˇ	muo
ㄇㄨㄛˋ	muo
ㄇㄨㄛ˙	muo
ㄇㄩ	mv
ㄇㄩˉ	mv
ㄇㄩˊ	mv
ㄇㄩˇ	mv
ㄇㄩˋ	mv
ㄇㄩ˙	mv
ㄇㄩㄝ	mve
ㄇㄩㄝˉ	mve
ㄇㄩㄝˊ	mve
ㄇㄩㄝˇ	mve
ㄇㄩㄝˋ	mve
ㄇㄩㄝ˙	mve
ㄇㄩㄣ	mvn
ㄇㄩㄣˉ	mvn
ㄇㄩㄣˊ	mvn
ㄇㄩㄣˇ	mvn
ㄇㄩㄣˋ	mvn
ㄇㄩㄣ˙	mvn
ㄇㄩㄥ	mvng
ㄇㄩㄥˉ	mvng
ㄇㄩㄥˊ	mvng
ㄇㄩㄥˇ	mvng
ㄇㄩㄥˋ	mvng
ㄇㄩㄥ˙	mvng
ㄇㄩ	myu
ㄇㄩˉ	myu
ㄇㄩˊ	myu
ㄇㄩˇ	myu
ㄇㄩˋ	myu
ㄇㄩ˙	myu
ㄇㄩㄝ	myue
ㄇㄩㄝˉ	myue
ㄇㄩㄝˊ	myue
ㄇㄩㄝˇ	myue
ㄇㄩㄝˋ	myue
ㄇㄩㄝ˙	myue
ㄇㄩㄣ	myun
ㄇㄩㄣˉ	myun
ㄇㄩㄣˊ	myun
ㄇㄩㄣˇ	myun
ㄇㄩㄣˋ	myun
ㄇㄩㄣ˙	myun
ㄇㄩㄥ	myung
ㄇㄩㄥˉ	myung
ㄇㄩㄥˊ	myung
ㄇㄩㄥˇ	myung
ㄇㄩㄥˋ	myung
ㄇㄩㄥ˙	myung
ㄋㄚ	na
ㄋㄚˉ	na
ㄋㄚˊ	na
ㄋㄚˇ	na
ㄋㄚˋ	na
ㄋㄚ˙	na
ㄋㄞ	nai
ㄋㄞˉ	nai
ㄋㄞˊ	nai
ㄋㄞˇ	nai
ㄋㄞˋ	nai
ㄋㄞ˙	nai
ㄋㄢ	nan
ㄋㄢˉ	nan
ㄋㄢˊ	nan
ㄋㄢˇ	nan
ㄋㄢˋ	nan
ㄋㄢ˙	nan
ㄋㄤ	nang
ㄋㄤˉ	nang
ㄋㄤˊ	nang
ㄋㄤˇ	nang
ㄋㄤˋ	nang
ㄋㄤ˙	nang
ㄋㄠ	nao
ㄋㄠˉ	nao
ㄋㄠˊ	nao
ㄋㄠˇ	nao
ㄋㄠˋ	nao
ㄋㄠ˙	nao
ㄋㄜ	ne
ㄋㄜˉ	ne
ㄋㄜˊ	ne
ㄋㄜˇ	ne
ㄋㄜˋ	ne
ㄋㄜ˙	ne
ㄋㄟ	nei
ㄋㄟˉ	nei
ㄋㄟˊ	nei
ㄋㄟˇ	nei
ㄋㄟˋ	nei
ㄋㄟ˙	nei
ㄋㄣ	nen
ㄋㄣˉ	nen
ㄋㄣˊ	nen
ㄋㄣˇ	nen
ㄋㄣˋ	nen
ㄋㄣ˙	nen
ㄋㄥ	neng
ㄋㄥˉ	neng
ㄋㄥˊ	neng
ㄋㄥˇ	neng
ㄋㄥˋ	neng
ㄋㄥ˙	neng
ㄋㄦ	ner
ㄋㄦˉ	ner
ㄋㄦˊ	ner
ㄋㄦˇ	ner
ㄋㄦˋ	ner
ㄋㄦ˙	ner
ㄋㄧ	ni
ㄋㄧˉ	ni
ㄋㄧˊ	ni
ㄋㄧˇ	ni
ㄋㄧˋ	ni
ㄋㄧ˙	ni
ㄋㄧㄚ	nia
ㄋㄧㄚˉ	nia
ㄋㄧㄚˊ	nia
ㄋㄧㄚˇ	nia
ㄋㄧㄚˋ	nia
ㄋㄧㄚ˙	nia
ㄋㄧㄢ	nian
ㄋㄧㄢˉ	nian
ㄋㄧㄢˊ	nian
ㄋㄧㄢˇ	nian
ㄋㄧㄢˋ	nian
ㄋㄧㄢ˙	nian
ㄋㄧㄤ	niang
ㄋㄧㄤˉ	niang
ㄋㄧㄤˊ	niang
ㄋㄧㄤˇ	niang
ㄋㄧㄤˋ	niang
ㄋㄧㄤ˙	niang
ㄋㄧㄠ	niao
ㄋㄧㄠˉ	niao
ㄋㄧㄠˊ	niao
ㄋㄧㄠˇ	niao
ㄋㄧㄠˋ	niao
ㄋㄧㄠ˙	niao
ㄋㄧㄝ	nie
ㄋㄧㄝˉ	nie
ㄋㄧㄝˊ	nie
ㄋㄧㄝˇ	nie
ㄋㄧㄝˋ	nie
ㄋㄧㄝ˙	nie
ㄋㄧㄣ	nin
ㄋㄧㄣˉ	nin
ㄋㄧㄣˊ	nin
ㄋㄧㄣˇ	nin
ㄋㄧㄣˋ	nin
ㄋㄧㄣ˙	nin
ㄋㄧㄥ	ning
ㄋㄧㄥˉ	ning
ㄋㄧㄥˊ	ning
ㄋㄧㄥˇ	ning
ㄋㄧㄥˋ	ning
ㄋㄧㄥ˙	ning
ㄋㄩㄥ	niong
ㄋㄩㄥˉ	niong
ㄋㄩㄥˊ	niong
ㄋㄩㄥˇ	niong
ㄋㄩㄥˋ	niong
ㄋㄩㄥ˙	niong
ㄋㄧㄡ	niou
ㄋㄧㄡˉ	niou
ㄋㄧㄡˊ	niou
ㄋㄧㄡˇ	niou
ㄋㄧㄡˋ	niou
ㄋㄧㄡ˙	niou
ㄋㄧㄡ	niu
ㄋㄧㄡˉ	niu
ㄋㄧㄡˊ	niu
ㄋㄧㄡˇ	niu
ㄋㄧㄡˋ	niu
ㄋㄧㄡ˙	niu
ㄋㄩㄥ	niung
ㄋㄩㄥˉ	niung
ㄋㄩㄥˊ	niung
ㄋㄩㄥˇ	niung
ㄋㄩㄥˋ	niung
ㄋㄩㄥ˙	niung
ㄋㄛ	no
ㄋㄛˉ	no
ㄋㄛˊ	no
ㄋㄛˇ	no
ㄋㄛˋ	no
ㄋㄛ˙	no
ㄋㄨㄥ	nong
ㄋㄨㄥˉ	nong
ㄋㄨㄥˊ	nong
ㄋㄨㄥˇ	nong
ㄋㄨㄥˋ	nong
ㄋㄨㄥ˙	nong
ㄋㄡ	nou
ㄋㄡˉ	nou
ㄋㄡˊ	nou
ㄋㄡˇ	nou
ㄋㄡˋ	nou
ㄋㄡ˙	nou
ㄋㄨ	nu
ㄋㄨˉ	nu
ㄋㄨˊ	nu
ㄋㄨˇ	nu
ㄋㄨˋ	nu
ㄋㄨ˙	nu
ㄋㄨㄚ	nua
ㄋㄨㄚˉ	nua
ㄋㄨㄚˊ	nua
ㄋㄨㄚˇ	nua
ㄋㄨㄚˋ	nua
ㄋㄨㄚ˙	nua
ㄋㄨㄞ	nuai
ㄋㄨㄞˉ	nuai
ㄋㄨㄞˊ	nuai
ㄋㄨㄞˇ	nuai
ㄋㄨㄞˋ	nuai
ㄋㄨㄞ˙	nuai
ㄋㄨㄢ	nuan
ㄋㄨㄢˉ	nuan
ㄋㄨㄢˊ	nuan
ㄋㄨㄢˇ	nuan
ㄋㄨㄢˋ	nuan
ㄋㄨㄢ˙	nuan
ㄋㄨㄤ	nuang
ㄋㄨㄤˉ	nuang
ㄋㄨㄤˊ	nuang
ㄋㄨㄤˇ	nuang
ㄋㄨㄤˋ	nuang
ㄋㄨㄤ˙	nuang
ㄋㄩㄝ	nue
ㄋㄩㄝˉ	nue
ㄋㄩㄝˊ	nue
ㄋㄩㄝˇ	nue
ㄋㄩㄝˋ	nue
ㄋㄩㄝ˙	nue
ㄋㄨㄟ	nui
ㄋㄨㄟˉ	nui
ㄋㄨㄟˊ	nui
ㄋㄨㄟˇ	nui
ㄋㄨㄟˋ	nui
ㄋㄨㄟ˙	nui
ㄋㄨㄣ	nun
ㄋㄨㄣˉ	nun
ㄋㄨㄣˊ	nun
ㄋㄨㄣˇ	nun
ㄋㄨㄣˋ	nun
ㄋㄨㄣ˙	nun
ㄋㄨㄥ	nung
ㄋㄨㄥˉ	nung
ㄋㄨㄥˊ	nung
ㄋㄨㄥˇ	nung
ㄋㄨㄥˋ	nung
ㄋㄨㄥ˙	nung
ㄋㄨㄛ	nuo
ㄋㄨㄛˉ	nuo
ㄋㄨㄛˊ	nuo
ㄋㄨㄛˇ	nuo
ㄋㄨㄛˋ	nuo
ㄋㄨㄛ˙	nuo
ㄋㄩ	nv
ㄋㄩˉ	nv
ㄋㄩˊ	nv
ㄋㄩˇ	nv
ㄋㄩˋ	nv
ㄋㄩ˙	nv
ㄋㄩㄝ	nve
ㄋㄩㄝˉ	nve
ㄋㄩㄝˊ	nve
ㄋㄩㄝˇ	nve
ㄋㄩㄝˋ	nve
ㄋㄩㄝ˙	nve
ㄋㄩㄣ	nvn
ㄋㄩㄣˉ	nvn
ㄋㄩㄣˊ	nvn
ㄋㄩㄣˇ	nvn
ㄋㄩㄣˋ	nvn
ㄋㄩㄣ˙	nvn
ㄋㄩㄥ	nvng
ㄋㄩㄥˉ	nvng
ㄋㄩㄥˊ	nvng
ㄋㄩㄥˇ	nvng
ㄋㄩㄥˋ	nvng
ㄋㄩㄥ˙	nvng
ㄋㄩ	nyu
ㄋㄩˉ	nyu
ㄋㄩˊ	nyu
ㄋㄩˇ	nyu
ㄋㄩˋ	nyu
ㄋㄩ˙	nyu
ㄋㄩㄝ	nyue
ㄋㄩㄝˉ	nyue
ㄋㄩㄝˊ	nyue
ㄋㄩㄝˇ	nyue
ㄋㄩㄝˋ	nyue
ㄋㄩㄝ˙	nyue
ㄋㄩㄣ	nyun
ㄋㄩㄣˉ	nyun
ㄋㄩㄣˊ	nyun
ㄋㄩㄣˇ	nyun
ㄋㄩㄣˋ	nyun
ㄋㄩㄣ˙	nyun
ㄋㄩㄥ	nyung
ㄋㄩㄥˉ	nyung
ㄋㄩㄥˊ	nyung
ㄋㄩㄥˇ	nyung
ㄋㄩㄥˋ	nyung
ㄋㄩㄥ˙	nyung
ㄛ	o
ㄛˉ	o
ㄛˊ	o
ㄛˇ	o
ㄛˋ	o
ㄛ˙	o
ㄨㄥ	ong
ㄨㄥˉ	ong
ㄨㄥˊ	ong
ㄨㄥˇ	ong
ㄨㄥˋ	ong
ㄨㄥ˙	ong
ㄡ	ou
ㄡˉ	ou
ㄡˊ	ou
ㄡˇ	ou
ㄡˋ	ou
ㄡ˙	ou
ㄆㄚ	pa
ㄆㄚˉ	pa
ㄆㄚˊ	pa
ㄆㄚˇ	pa
ㄆㄚˋ	pa
ㄆㄚ˙	pa
ㄆㄞ	pai
ㄆㄞˉ	pai
ㄆㄞˊ	pai
ㄆㄞˇ	pai
ㄆㄞˋ	pai
ㄆㄞ˙	pai
ㄆㄢ	pan
ㄆㄢˉ	pan
ㄆㄢˊ	pan
ㄆㄢˇ	pan
ㄆㄢˋ	pan
ㄆㄢ˙	pan
ㄆㄤ	pang
ㄆㄤˉ	pang
ㄆㄤˊ	pang
ㄆㄤˇ	pang
ㄆㄤˋ	pang
ㄆㄤ˙	pang
ㄆㄠ	pao
ㄆㄠˉ	pao
ㄆㄠˊ	pao
ㄆㄠˇ	pao
ㄆㄠˋ	pao
ㄆㄠ˙	pao
ㄆㄜ	pe
ㄆㄜˉ	pe
ㄆㄜˊ	pe
ㄆㄜˇ	pe
ㄆㄜˋ	pe
ㄆㄜ˙	pe
ㄆㄟ	pei
ㄆㄟˉ	pei
ㄆㄟˊ	pei
ㄆㄟˇ	pei
ㄆㄟˋ	pei
ㄆㄟ˙	pei
ㄆㄣ	pen
ㄆㄣˉ	pen
ㄆㄣˊ	pen
ㄆㄣˇ	pen
ㄆㄣˋ	pen
ㄆㄣ˙	pen
ㄆㄥ	peng
ㄆㄥˉ	peng
ㄆㄥˊ	peng
ㄆㄥˇ	peng
ㄆㄥˋ	peng
ㄆㄥ˙	peng
ㄆㄦ	per
ㄆㄦˉ	per
ㄆㄦˊ	per
ㄆㄦˇ	per
ㄆㄦˋ	per
ㄆㄦ˙	per
ㄆㄧ	pi
ㄆㄧˉ	pi
ㄆㄧˊ	pi
ㄆㄧˇ	pi
ㄆㄧˋ	pi
ㄆㄧ˙	pi
ㄆㄧㄚ	pia
ㄆㄧㄚˉ	pia
ㄆㄧㄚˊ	pia
ㄆㄧㄚˇ	pia
ㄆㄧㄚˋ	pia
ㄆㄧㄚ˙	pia
ㄆㄧㄢ	pian
ㄆㄧㄢˉ	pian
ㄆㄧㄢˊ	pian
ㄆㄧㄢˇ	pian
ㄆㄧㄢˋ	pian
ㄆㄧㄢ˙	pian
ㄆㄧㄤ	piang
ㄆㄧㄤˉ	piang
ㄆㄧㄤˊ	piang
ㄆㄧㄤˇ	piang
ㄆㄧㄤˋ	piang
ㄆㄧㄤ˙	piang
ㄆㄧㄠ	piao
ㄆㄧㄠˉ	piao
ㄆㄧㄠˊ	piao
ㄆㄧㄠˇ	piao
ㄆㄧㄠˋ	piao
ㄆㄧㄠ˙	piao
ㄆㄧㄝ	pie
ㄆㄧㄝˉ	pie
ㄆㄧㄝˊ	pie
ㄆㄧㄝˇ	pie
ㄆㄧㄝˋ	pie
ㄆㄧㄝ˙	pie
ㄆㄧㄣ	pin
ㄆㄧㄣˉ	pin
ㄆㄧㄣˊ	pin
ㄆㄧㄣˇ	pin
ㄆㄧㄣˋ	pin
ㄆㄧㄣ˙	pin
ㄆㄧㄥ	ping
ㄆㄧㄥˉ	ping
ㄆㄧㄥˊ	ping
ㄆㄧㄥˇ	ping
ㄆㄧㄥˋ	ping
ㄆㄧㄥ˙	ping
ㄆㄩㄥ	piong
ㄆㄩㄥˉ	piong
ㄆㄩㄥˊ	piong
ㄆㄩㄥˇ	piong
ㄆㄩㄥˋ	piong
ㄆㄩㄥ˙	piong
ㄆㄧㄡ	piou
ㄆㄧㄡˉ	piou
ㄆㄧㄡˊ	piou
ㄆㄧㄡˇ	piou
ㄆㄧㄡˋ	piou
ㄆㄧㄡ˙	piou
ㄆㄧㄡ	piu
ㄆㄧㄡˉ	piu
ㄆㄧㄡˊ	piu
ㄆㄧㄡˇ	piu
ㄆㄧㄡˋ	piu
ㄆㄧㄡ˙	piu
ㄆㄩㄥ	piung
ㄆㄩㄥˉ	piung
ㄆㄩㄥˊ	piung
ㄆㄩㄥˇ	piung
ㄆㄩㄥˋ	piung
ㄆㄩㄥ˙	piung
ㄆㄛ	po
ㄆㄛˉ	po
ㄆㄛˊ	po
ㄆㄛˇ	po
ㄆㄛˋ	po
ㄆㄛ˙	po
ㄆㄨㄥ	pong
ㄆㄨㄥˉ	pong
ㄆㄨㄥˊ	pong
ㄆㄨㄥˇ	pong
ㄆㄨㄥˋ	pong
ㄆㄨㄥ˙	pong
ㄆㄡ	pou
ㄆㄡˉ	pou
ㄆㄡˊ	pou
ㄆㄡˇ	pou
ㄆㄡˋ	pou
ㄆㄡ˙	pou
ㄆㄨ	pu
ㄆㄨˉ	pu
ㄆㄨˊ	pu
ㄆㄨˇ	pu
ㄆㄨˋ	pu
ㄆㄨ˙	pu
ㄆㄨㄚ	pua
ㄆㄨㄚˉ	pua
ㄆㄨㄚˊ	pua
ㄆㄨㄚˇ	pua
ㄆㄨㄚˋ	pua
ㄆㄨㄚ˙	pua
ㄆㄨㄞ	puai
ㄆㄨㄞˉ	puai
ㄆㄨㄞˊ	puai
ㄆㄨㄞˇ	puai
ㄆㄨㄞˋ	puai
ㄆㄨㄞ˙	puai
ㄆㄨㄢ	puan
ㄆㄨㄢˉ	puan
ㄆㄨㄢˊ	puan
ㄆㄨㄢˇ	puan
ㄆㄨㄢˋ	puan
ㄆㄨㄢ˙	puan
ㄆㄨㄤ	puang
ㄆㄨㄤˉ	puang
ㄆㄨㄤˊ	puang
ㄆㄨㄤˇ	puang
ㄆㄨㄤˋ	puang
ㄆㄨㄤ˙	puang
ㄆㄨㄟ	pui
ㄆㄨㄟˉ	pui
ㄆㄨㄟˊ	pui
ㄆㄨㄟˇ	pui
ㄆㄨㄟˋ	pui
ㄆㄨㄟ˙	pui
ㄆㄨㄣ	pun
ㄆㄨㄣˉ	pun
ㄆㄨㄣˊ	pun
ㄆㄨㄣˇ	pun
ㄆㄨㄣˋ	pun
ㄆㄨㄣ˙	pun
ㄆㄨㄥ	pung
ㄆㄨㄥˉ	pung
ㄆㄨㄥˊ	pung
ㄆㄨㄥˇ	pung
ㄆㄨㄥˋ	pung
ㄆㄨㄥ˙	pung
ㄆㄨㄛ	puo
ㄆㄨㄛˉ	puo
ㄆㄨㄛˊ	puo
ㄆㄨㄛˇ	puo
ㄆㄨㄛˋ	puo
ㄆㄨㄛ˙	puo
ㄆㄩ	pv
ㄆㄩˉ	pv
ㄆㄩˊ	pv
ㄆㄩˇ	pv
ㄆㄩˋ	pv
ㄆㄩ˙	pv
ㄆㄩㄝ	pve
ㄆㄩㄝˉ	pve
ㄆㄩㄝˊ	pve
ㄆㄩㄝˇ	pve
ㄆㄩㄝˋ	pve
ㄆㄩㄝ˙	pve
ㄆㄩㄣ	pvn
ㄆㄩㄣˉ	pvn
ㄆㄩㄣˊ	pvn
ㄆㄩㄣˇ	pvn
ㄆㄩㄣˋ	pvn
ㄆㄩㄣ˙	pvn
ㄆㄩㄥ	pvng
ㄆㄩㄥˉ	pvng
ㄆㄩㄥˊ	pvng
ㄆㄩㄥˇ	pvng
ㄆㄩㄥˋ	pvng
ㄆㄩㄥ˙	pvng
ㄆㄩ	pyu
ㄆㄩˉ	pyu
ㄆㄩˊ	pyu
ㄆㄩˇ	pyu
ㄆㄩˋ	pyu
ㄆㄩ˙	pyu
ㄆㄩㄝ	pyue
ㄆㄩㄝˉ	pyue
ㄆㄩㄝˊ	pyue
ㄆㄩㄝˇ	pyue
ㄆㄩㄝˋ	pyue
ㄆㄩㄝ˙	pyue
ㄆㄩㄣ	pyun
ㄆㄩㄣˉ	pyun
ㄆㄩㄣˊ	pyun
ㄆㄩㄣˇ	pyun
ㄆㄩㄣˋ	pyun
ㄆㄩㄣ˙	pyun
ㄆㄩㄥ	pyung
ㄆㄩㄥˉ	pyung
ㄆㄩㄥˊ	pyung
ㄆㄩㄥˇ	pyung
ㄆㄩㄥˋ	pyung
ㄆㄩㄥ˙	pyung
ㄑㄚ	qa
ㄑㄚˉ	qa
ㄑㄚˊ	qa
ㄑㄚˇ	qa
ㄑㄚˋ	qa
ㄑㄚ˙	qa
ㄑㄞ	qai
ㄑㄞˉ	qai
ㄑㄞˊ	qai
ㄑㄞˇ	qai
ㄑㄞˋ	qai
ㄑㄞ˙	qai
ㄑㄢ	qan
ㄑㄢˉ	qan
ㄑㄢˊ	qan
ㄑㄢˇ	qan
ㄑㄢˋ	qan
ㄑㄢ˙	qan
ㄑㄤ	qang
ㄑㄤˉ	qang
ㄑㄤˊ	qang
ㄑㄤˇ	qang
ㄑㄤˋ	qang
ㄑㄤ˙	qang
ㄑㄠ	qao
ㄑㄠˉ	qao
ㄑㄠˊ	qao
ㄑㄠˇ	qao
ㄑㄠˋ	qao
ㄑㄠ˙	qao
ㄑㄜ	qe
ㄑㄜˉ	qe
ㄑㄜˊ	qe
ㄑㄜˇ	qe
ㄑㄜˋ	qe
ㄑㄜ˙	qe
ㄑㄟ	qei
ㄑㄟˉ	qei
ㄑㄟˊ	qei
ㄑㄟˇ	qei
ㄑㄟˋ	qei
ㄑㄟ˙	qei
ㄑㄣ	qen
ㄑㄣˉ	qen
ㄑㄣˊ	qen
ㄑㄣˇ	qen
ㄑㄣˋ	qen
ㄑㄣ˙	qen
ㄑㄥ	qeng
ㄑㄥˉ	qeng
ㄑㄥˊ	qeng
ㄑㄥˇ	qeng
ㄑㄥˋ	qeng
ㄑㄥ˙	qeng
ㄑㄦ	qer
ㄑㄦˉ	qer
ㄑㄦˊ	qer
ㄑㄦˇ	qer
ㄑㄦˋ	qer
ㄑㄦ˙	qer
ㄑㄧ	qi
ㄑㄧˉ	qi
ㄑㄧˊ	qi
ㄑㄧˇ	qi
ㄑㄧˋ	qi
ㄑㄧ˙	qi
ㄑㄧㄚ	qia
ㄑㄧㄚˉ	qia
ㄑㄧㄚˊ	qia
ㄑㄧㄚˇ	qia
ㄑㄧㄚˋ	qia
ㄑㄧㄚ˙	qia
ㄑㄧㄢ	qian
ㄑㄧㄢˉ	qian
ㄑㄧㄢˊ	qian
ㄑㄧㄢˇ	qian
ㄑㄧㄢˋ	qian
ㄑㄧㄢ˙	qian
ㄑㄧㄤ	qiang
ㄑㄧㄤˉ	qiang
ㄑㄧㄤˊ	qiang
ㄑㄧㄤˇ	qiang
ㄑㄧㄤˋ	qiang
ㄑㄧㄤ˙	qiang
ㄑㄧㄠ	qiao
ㄑㄧㄠˉ	qiao
ㄑㄧㄠˊ	qiao
ㄑㄧㄠˇ	qiao
ㄑㄧㄠˋ	qiao
ㄑㄧㄠ˙	qiao
ㄑㄧㄝ	qie
ㄑㄧㄝˉ	qie
ㄑㄧㄝˊ	qie
ㄑㄧㄝˇ	qie
ㄑㄧㄝˋ	qie
ㄑㄧㄝ˙	qie
ㄑㄧㄣ	qin
ㄑㄧㄣˉ	qin
ㄑㄧㄣˊ	qin
ㄑㄧㄣˇ	qin
ㄑㄧㄣˋ	qin
ㄑㄧㄣ˙	qin
ㄑㄧㄥ	qing
ㄑㄧㄥˉ	qing
ㄑㄧㄥˊ	qing
ㄑㄧㄥˇ	qing
ㄑㄧㄥˋ	qing
ㄑㄧㄥ˙	qing
ㄑㄩㄥ	qiong
ㄑㄩㄥˉ	qiong
ㄑㄩㄥˊ	qiong
ㄑㄩㄥˇ	qiong
ㄑㄩㄥˋ	qiong
ㄑㄩㄥ˙	qiong
ㄑㄧㄡ	qiou
ㄑㄧㄡˉ	qiou
ㄑㄧㄡˊ	qiou
ㄑㄧㄡˇ	qiou
ㄑㄧㄡˋ	qiou
ㄑㄧㄡ˙	qiou
ㄑㄧㄡ	qiu
ㄑㄧㄡˉ	qiu
ㄑㄧㄡˊ	qiu
ㄑㄧㄡˇ	qiu
ㄑㄧㄡˋ	qiu
ㄑㄧㄡ˙	qiu
ㄑㄩㄥ	qiung
ㄑㄩㄥˉ	qiung
ㄑㄩㄥˊ	qiung
ㄑㄩㄥˇ	qiung
ㄑㄩㄥˋ	qiung
ㄑㄩㄥ˙	qiung
ㄑㄛ	qo
ㄑㄛˉ	qo
ㄑㄛˊ	qo
ㄑㄛˇ	qo
ㄑㄛˋ	qo
ㄑㄛ˙	qo
ㄑㄨㄥ	qong
ㄑㄨㄥˉ	qong
ㄑㄨㄥˊ	qong
ㄑㄨㄥˇ	qong
ㄑㄨㄥˋ	qong
ㄑㄨㄥ˙	qong
ㄑㄡ	qou
ㄑㄡˉ	qou
ㄑㄡˊ	qou
ㄑㄡˇ	qou
ㄑㄡˋ	qou
ㄑㄡ˙	qou
ㄑㄨ	qu
ㄑㄨˉ	qu
ㄑㄨˊ	qu
ㄑㄨˇ	qu
ㄑㄨˋ	qu
ㄑㄨ˙	qu
ㄑㄨㄚ	qua
ㄑㄨㄚˉ	qua
ㄑㄨㄚˊ	qua
ㄑㄨㄚˇ	qua
ㄑㄨㄚˋ	qua
ㄑㄨㄚ˙	qua
ㄑㄨㄞ	quai
ㄑㄨㄞˉ	quai
ㄑㄨㄞˊ	quai
ㄑㄨㄞˇ	quai
ㄑㄨㄞˋ	quai
ㄑㄨㄞ˙	quai
ㄑㄨㄢ	quan
ㄑㄨㄢˉ	quan
ㄑㄨㄢˊ	quan
ㄑㄨㄢˇ	quan
ㄑㄨㄢˋ	quan
ㄑㄨㄢ˙	quan
ㄑㄨㄤ	quang
ㄑㄨㄤˉ	quang
ㄑㄨㄤˊ	quang
ㄑㄨㄤˇ	quang
ㄑㄨㄤˋ	quang
ㄑㄨㄤ˙	quang
ㄑㄩㄝ	que
ㄑㄩㄝˉ	que
ㄑㄩㄝˊ	que
ㄑㄩㄝˇ	que
ㄑㄩㄝˋ	que
ㄑㄩㄝ˙	que
ㄑㄨㄟ	qui
ㄑㄨㄟˉ	qui
ㄑㄨㄟˊ	qui
ㄑㄨㄟˇ	qui
ㄑㄨㄟˋ	qui
ㄑㄨㄟ˙	qui
ㄑㄨㄣ	qun
ㄑㄨㄣˉ	qun
ㄑㄨㄣˊ	qun
ㄑㄨㄣˇ	qun
ㄑㄨㄣˋ	qun
ㄑㄨㄣ˙	qun
ㄑㄨㄥ	qung
ㄑㄨㄥˉ	qung
ㄑㄨㄥˊ	qung
ㄑㄨㄥˇ	qung
ㄑㄨㄥˋ	qung
ㄑㄨㄥ˙	qung
ㄑㄨㄛ	quo
ㄑㄨㄛˉ	quo
ㄑㄨㄛˊ	quo
ㄑㄨㄛˇ	quo
ㄑㄨㄛˋ	quo
ㄑㄨㄛ˙	quo
ㄑㄩ	qv
ㄑㄩˉ	qv
ㄑㄩˊ	qv
ㄑㄩˇ	qv
ㄑㄩˋ	qv
ㄑㄩ˙	qv
ㄑㄩㄝ	qve
ㄑㄩㄝˉ	qve
ㄑㄩㄝˊ	qve
ㄑㄩㄝˇ	qve
ㄑㄩㄝˋ	qve
ㄑㄩㄝ˙	qve
ㄑㄩㄣ	qvn
ㄑㄩㄣˉ	qvn
ㄑㄩㄣˊ	qvn
ㄑㄩㄣˇ	qvn
ㄑㄩㄣˋ	qvn
ㄑㄩㄣ˙	qvn
ㄑㄩㄥ	qvng
ㄑㄩㄥˉ	qvng
ㄑㄩㄥˊ	qvng
ㄑㄩㄥˇ	qvng
ㄑㄩㄥˋ	qvng
ㄑㄩㄥ˙	qvng
ㄑㄩ	qyu
ㄑㄩˉ	qyu
ㄑㄩˊ	qyu
ㄑㄩˇ	qyu
ㄑㄩˋ	qyu
ㄑㄩ˙	qyu
ㄑㄩㄝ	qyue
ㄑㄩㄝˉ	qyue
ㄑㄩㄝˊ	qyue
ㄑㄩㄝˇ	qyue
ㄑㄩㄝˋ	qyue
ㄑㄩㄝ˙	qyue
ㄑㄩㄣ	qyun
ㄑㄩㄣˉ	qyun
ㄑㄩㄣˊ	qyun
ㄑㄩㄣˇ	qyun
ㄑㄩㄣˋ	qyun
ㄑㄩㄣ˙	qyun
ㄑㄩㄥ	qyung
ㄑㄩㄥˉ	qyung
ㄑㄩㄥˊ	qyung
ㄑㄩㄥˇ	qyung
ㄑㄩㄥˋ	qyung
ㄑㄩㄥ˙	qyung
ㄖㄚ	ra
ㄖㄚˉ	ra
ㄖㄚˊ	ra
ㄖㄚˇ	ra
ㄖㄚˋ	ra
ㄖㄚ˙	ra
ㄖㄞ	rai
ㄖㄞˉ	rai
ㄖㄞˊ	rai
ㄖㄞˇ	rai
ㄖㄞˋ	rai
ㄖㄞ˙	rai
ㄖㄢ	ran
ㄖㄢˉ	ran
ㄖㄢˊ	ran
ㄖㄢˇ	ran
ㄖㄢˋ	ran
ㄖㄢ˙	ran
ㄖㄤ	rang
ㄖㄤˉ	rang
ㄖㄤˊ	rang
ㄖㄤˇ	rang
ㄖㄤˋ	rang
ㄖㄤ˙	rang
ㄖㄠ	rao
ㄖㄠˉ	rao
ㄖㄠˊ	rao
ㄖㄠˇ	rao
ㄖㄠˋ	rao
ㄖㄠ˙	rao
ㄖㄜ	re
ㄖㄜˉ	re
ㄖㄜˊ	re
ㄖㄜˇ	re
ㄖㄜˋ	re
ㄖㄜ˙	re
ㄖㄟ	rei
ㄖㄟˉ	rei
ㄖㄟˊ	rei
ㄖㄟˇ	rei
ㄖㄟˋ	rei
ㄖㄟ˙	rei
ㄖㄣ	ren
ㄖㄣˉ	ren
ㄖㄣˊ	ren
ㄖㄣˇ	ren
ㄖㄣˋ	ren
ㄖㄣ˙	ren
ㄖㄥ	reng
ㄖㄥˉ	reng
ㄖㄥˊ	reng
ㄖㄥˇ	reng
ㄖㄥˋ	reng
ㄖㄥ˙	reng
ㄖㄦ	rer
ㄖㄦˉ	rer
ㄖㄦˊ	rer
ㄖㄦˇ	rer
ㄖㄦˋ	rer
ㄖㄦ˙	rer
ㄖ	ri
ㄖˉ	ri
ㄖˊ	ri
ㄖˇ	ri
ㄖˋ	ri
ㄖ˙	ri
ㄖㄧ	ri
ㄖㄧˉ	ri
ㄖㄧˊ	ri
ㄖㄧˇ	ri
ㄖㄧˋ	ri
ㄖㄧ˙	ri
ㄖㄧㄚ	ria
ㄖㄧㄚˉ	ria
ㄖㄧㄚˊ	ria
ㄖㄧㄚˇ	ria
ㄖㄧㄚˋ	ria
ㄖㄧㄚ˙	ria
ㄖㄧㄢ	rian
ㄖㄧㄢˉ	rian
ㄖㄧㄢˊ	rian
ㄖㄧㄢˇ	rian
ㄖㄧㄢˋ	rian
ㄖㄧㄢ˙	rian
ㄖㄧㄤ	riang
ㄖㄧㄤˉ	riang
ㄖㄧㄤˊ	riang
ㄖㄧㄤˇ	riang
ㄖㄧㄤˋ	riang
ㄖㄧㄤ˙	riang
ㄖㄧㄠ	riao
ㄖㄧㄠˉ	riao
ㄖㄧㄠˊ	riao
ㄖㄧㄠˇ	riao
ㄖㄧㄠˋ	riao
ㄖㄧㄠ˙	riao
ㄖㄧㄝ	rie
ㄖㄧㄝˉ	rie
ㄖㄧㄝˊ	rie
ㄖㄧㄝˇ	rie
ㄖㄧㄝˋ	rie
ㄖㄧㄝ˙	rie
ㄖㄧㄣ	rin
ㄖㄧㄣˉ	rin
ㄖㄧㄣˊ	rin
ㄖㄧㄣˇ	rin
ㄖㄧㄣˋ	rin
ㄖㄧㄣ˙	rin
ㄖㄧㄥ	ring
ㄖㄧㄥˉ	ring
ㄖㄧㄥˊ	ring
ㄖㄧㄥˇ	ring
ㄖㄧㄥˋ	ring
ㄖㄧㄥ˙	ring
ㄖㄩㄥ	riong
ㄖㄩㄥˉ	riong
ㄖㄩㄥˊ	riong
ㄖㄩㄥˇ	riong
ㄖㄩㄥˋ	riong
ㄖㄩㄥ˙	riong
ㄖㄧㄡ	riou
ㄖㄧㄡˉ	riou
ㄖㄧㄡˊ	riou
ㄖㄧㄡˇ	riou
ㄖㄧㄡˋ	riou
ㄖㄧㄡ˙	riou
ㄖㄧㄡ	riu
ㄖㄧㄡˉ	riu
ㄖㄧㄡˊ	riu
ㄖㄧㄡˇ	riu
ㄖㄧㄡˋ	riu
ㄖㄧㄡ˙	riu
ㄖㄩㄥ	riung
ㄖㄩㄥˉ	riung
ㄖㄩㄥˊ	riung
ㄖㄩㄥˇ	riung
ㄖㄩㄥˋ	riung
ㄖㄩㄥ˙	riung
ㄖㄛ	ro
ㄖㄛˉ	ro
ㄖㄛˊ	ro
ㄖㄛˇ	ro
ㄖㄛˋ	ro
ㄖㄛ˙	ro
ㄖㄨㄥ	rong
ㄖㄨㄥˉ	rong
ㄖㄨㄥˊ	rong
ㄖㄨㄥˇ	rong
ㄖㄨㄥˋ	rong
ㄖㄨㄥ˙	rong
ㄖㄡ	rou
ㄖㄡˉ	rou
ㄖㄡˊ	rou
ㄖㄡˇ	rou
ㄖㄡˋ	rou
ㄖㄡ˙	rou
ㄖㄨ	ru
ㄖㄨˉ	ru
ㄖㄨˊ	ru
ㄖㄨˇ	ru
ㄖㄨˋ	ru
ㄖㄨ˙	ru
ㄖㄨㄚ	rua
ㄖㄨㄚˉ	rua
ㄖㄨㄚˊ	rua
ㄖㄨㄚˇ	rua
ㄖㄨㄚˋ	rua
ㄖㄨㄚ˙	rua
ㄖㄨㄞ	ruai
ㄖㄨㄞˉ	ruai
ㄖㄨㄞˊ	ruai
ㄖㄨㄞˇ	ruai
ㄖㄨㄞˋ	ruai
ㄖㄨㄞ˙	ruai
ㄖㄨㄢ	ruan
ㄖㄨㄢˉ	ruan
ㄖㄨㄢˊ	ruan
ㄖㄨㄢˇ	ruan
ㄖㄨㄢˋ	ruan
ㄖㄨㄢ˙	ruan
ㄖㄨㄤ	ruang
ㄖㄨㄤˉ	ruang
ㄖㄨㄤˊ	ruang
ㄖㄨㄤˇ	ruang
ㄖㄨㄤˋ	ruang
ㄖㄨㄤ˙	ruang
ㄖㄨㄟ	rui
ㄖㄨㄟˉ	rui
ㄖㄨㄟˊ	rui
ㄖㄨㄟˇ	rui
ㄖㄨㄟˋ	rui
ㄖㄨㄟ˙	rui
ㄖㄨㄣ	run
ㄖㄨㄣˉ	run
ㄖㄨㄣˊ	run
ㄖㄨㄣˇ	run
ㄖㄨㄣˋ	run
ㄖㄨㄣ˙	run
ㄖㄨㄥ	rung
ㄖㄨㄥˉ	rung
ㄖㄨㄥˊ	rung
ㄖㄨㄥˇ	rung
ㄖㄨㄥˋ	rung
ㄖㄨㄥ˙	rung
ㄖㄨㄛ	ruo
ㄖㄨㄛˉ	ruo
ㄖㄨㄛˊ	ruo
ㄖㄨㄛˇ	ruo
ㄖㄨㄛˋ	ruo
ㄖㄨㄛ˙	ruo
ㄖㄩ	rv
ㄖㄩˉ	rv
ㄖㄩˊ	rv
ㄖㄩˇ	rv
ㄖㄩˋ	rv
ㄖㄩ˙	rv
ㄖㄩㄝ	rve
ㄖㄩㄝˉ	rve
ㄖㄩㄝˊ	rve
ㄖㄩㄝˇ	rve
ㄖㄩㄝˋ	rve
ㄖㄩㄝ˙	rve
ㄖㄩㄣ	rvn
ㄖㄩㄣˉ	rvn
ㄖㄩㄣˊ	rvn
ㄖㄩㄣˇ	rvn
ㄖㄩㄣˋ	rvn
ㄖㄩㄣ˙	rvn
ㄖㄩㄥ	rvng
ㄖㄩㄥˉ	rvng
ㄖㄩㄥˊ	rvng
ㄖㄩㄥˇ	rvng
ㄖㄩㄥˋ	rvng
ㄖㄩㄥ˙	rvng
ㄖㄩ	ryu
ㄖㄩˉ	ryu
ㄖㄩˊ	ryu
ㄖㄩˇ	ryu
ㄖㄩˋ	ryu
ㄖㄩ˙	ryu
ㄖㄩㄝ	ryue
ㄖㄩㄝˉ	ryue
ㄖㄩㄝˊ	ryue
ㄖㄩㄝˇ	ryue
ㄖㄩㄝˋ	ryue
ㄖㄩㄝ˙	ryue
ㄖㄩㄣ	ryun
ㄖㄩㄣˉ	ryun
ㄖㄩㄣˊ	ryun
ㄖㄩㄣˇ	ryun
ㄖㄩㄣˋ	ryun
ㄖㄩㄣ˙	ryun
ㄖㄩㄥ	ryung
ㄖㄩㄥˉ	ryung
ㄖㄩㄥˊ	ryung
ㄖㄩㄥˇ	ryung
ㄖㄩㄥˋ	ryung
ㄖㄩㄥ˙	ryung
ㄙㄚ	sa
ㄙㄚˉ	sa
ㄙㄚˊ	sa
ㄙㄚˇ	sa
ㄙㄚˋ	sa
ㄙㄚ˙	sa
ㄙㄞ	sai
ㄙㄞˉ	sai
ㄙㄞˊ	sai
ㄙㄞˇ	sai
ㄙㄞˋ	sai
ㄙㄞ˙	sai
ㄙㄢ	san
ㄙㄢˉ	san
ㄙㄢˊ	san
ㄙㄢˇ	san
ㄙㄢˋ	san
ㄙㄢ˙	san
ㄙㄤ	sang
ㄙㄤˉ	sang
ㄙㄤˊ	sang
ㄙㄤˇ	sang
ㄙㄤˋ	sang
ㄙㄤ˙	sang
ㄙㄠ	sao
ㄙㄠˉ	sao
ㄙㄠˊ	sao
ㄙㄠˇ	sao
ㄙㄠˋ	sao
ㄙㄠ˙	sao
ㄙㄜ	se
ㄙㄜˉ	se
ㄙㄜˊ	se
ㄙㄜˇ	se
ㄙㄜˋ	se
ㄙㄜ˙	se
ㄙㄟ	sei
ㄙㄟˉ	sei
ㄙㄟˊ	sei
ㄙㄟˇ	sei
ㄙㄟˋ	sei
ㄙㄟ˙	sei
ㄙㄣ	sen
ㄙㄣˉ	sen
ㄙㄣˊ	sen
ㄙㄣˇ	sen
ㄙㄣˋ	sen
ㄙㄣ˙	sen
ㄙㄥ	seng
ㄙㄥˉ	seng
ㄙㄥˊ	seng
ㄙㄥˇ	seng
ㄙㄥˋ	seng
ㄙㄥ˙	seng
ㄙㄦ	ser
ㄙㄦˉ	ser
ㄙㄦˊ	ser
ㄙㄦˇ	ser
ㄙㄦˋ	ser
ㄙㄦ˙	ser
ㄕㄚ	sha
ㄕㄚˉ	sha
ㄕㄚˊ	sha
ㄕㄚˇ	sha
ㄕㄚˋ	sha
ㄕㄚ˙	sha
ㄕㄞ	shai
ㄕㄞˉ	shai
ㄕㄞˊ	shai
ㄕㄞˇ	shai
ㄕㄞˋ	shai
ㄕㄞ˙	shai
ㄕㄢ	shan
ㄕㄢˉ	shan
ㄕㄢˊ	shan
ㄕㄢˇ	shan
ㄕㄢˋ	shan
ㄕㄢ˙	shan
ㄕㄤ	shang
ㄕㄤˉ	shang
ㄕㄤˊ	shang
ㄕㄤˇ	shang
ㄕㄤˋ	shang
ㄕㄤ˙	shang
ㄕㄠ	shao
ㄕㄠˉ	shao
ㄕㄠˊ	shao
ㄕㄠˇ	shao
ㄕㄠˋ	shao
ㄕㄠ˙	shao
ㄕㄜ	she
ㄕㄜˉ	she
ㄕㄜˊ	she
ㄕㄜˇ	she
ㄕㄜˋ	she
ㄕㄜ˙	she
ㄕㄟ	shei
ㄕㄟˉ	shei
ㄕㄟˊ	shei
ㄕㄟˇ	shei
ㄕㄟˋ	shei
ㄕㄟ˙	shei
ㄕㄣ	shen
ㄕㄣˉ	shen
ㄕㄣˊ	shen
ㄕㄣˇ	shen
ㄕㄣˋ	shen
ㄕㄣ˙	shen
ㄕㄥ	sheng
ㄕㄥˉ	sheng
ㄕㄥˊ	sheng
ㄕㄥˇ	sheng
ㄕㄥˋ	sheng
ㄕㄥ˙	sheng
ㄕㄦ	sher
ㄕㄦˉ	sher
ㄕㄦˊ	sher
ㄕㄦˇ	sher
ㄕㄦˋ	sher
ㄕㄦ˙	sher
ㄕ	shi
ㄕˉ	shi
ㄕˊ	shi
ㄕˇ	shi
ㄕˋ	shi
ㄕ˙	shi
ㄕㄧ	shi
ㄕㄧˉ	shi
ㄕㄧˊ	shi
ㄕㄧˇ	shi
ㄕㄧˋ	shi
ㄕㄧ˙	shi
ㄕㄧㄚ	shia
ㄕㄧㄚˉ	shia
ㄕㄧㄚˊ	shia
ㄕㄧㄚˇ	shia
ㄕㄧㄚˋ	shia
ㄕㄧㄚ˙	shia
ㄕㄧㄢ	shian
ㄕㄧㄢˉ	shian
ㄕㄧㄢˊ	shian
ㄕㄧㄢˇ	shian
ㄕㄧㄢˋ	shian
ㄕㄧㄢ˙	shian
ㄕㄧㄤ	shiang
ㄕㄧㄤˉ	shiang
ㄕㄧㄤˊ	shiang
ㄕㄧㄤˇ	shiang
ㄕㄧㄤˋ	shiang
ㄕㄧㄤ˙	shiang
ㄕㄧㄠ	shiao
ㄕㄧㄠˉ	shiao
ㄕㄧㄠˊ	shiao
ㄕㄧㄠˇ	shiao
ㄕㄧㄠˋ	shiao
ㄕㄧㄠ˙	shiao
ㄕㄧㄝ	shie
ㄕㄧㄝˉ	shie
ㄕㄧㄝˊ	shie
ㄕㄧㄝˇ	shie
ㄕㄧㄝˋ	shie
ㄕㄧㄝ˙	shie
ㄕㄧㄣ	shin
ㄕㄧㄣˉ	shin
ㄕㄧㄣˊ	shin
ㄕㄧㄣˇ	shin
ㄕㄧㄣˋ	shin
ㄕㄧㄣ˙	shin
ㄕㄧㄥ	shing
ㄕㄧㄥˉ	shing
ㄕㄧㄥˊ	shing
ㄕㄧㄥˇ	shing
ㄕㄧㄥˋ	shing
ㄕㄧㄥ˙	shing
ㄕㄩㄥ	shiong
ㄕㄩㄥˉ	shiong
ㄕㄩㄥˊ	shiong
ㄕㄩㄥˇ	shiong
ㄕㄩㄥˋ	shiong
ㄕㄩㄥ˙	shiong
ㄕㄧㄡ	shiou
ㄕㄧㄡˉ	shiou
ㄕㄧㄡˊ	shiou
ㄕㄧㄡˇ	shiou
ㄕㄧㄡˋ	shiou
ㄕㄧㄡ˙	shiou
ㄕㄧㄡ	shiu
ㄕㄧㄡˉ	shiu
ㄕㄧㄡˊ	shiu
ㄕㄧㄡˇ	shiu
ㄕㄧㄡˋ	shiu
ㄕㄧㄡ˙	shiu
ㄕㄩㄥ	shiung
ㄕㄩㄥˉ	shiung
ㄕㄩㄥˊ	shiung
ㄕㄩㄥˇ	shiung
ㄕㄩㄥˋ	shiung
ㄕㄩㄥ˙	shiung
ㄕㄛ	sho
ㄕㄛˉ	sho
ㄕㄛˊ	sho
ㄕㄛˇ	sho
ㄕㄛˋ	sho
ㄕㄛ˙	sho
ㄕㄨㄥ	shong
ㄕㄨㄥˉ	shong
ㄕㄨㄥˊ	shong
ㄕㄨㄥˇ	shong
ㄕㄨㄥˋ	shong
ㄕㄨㄥ˙	shong
ㄕㄡ	shou
ㄕㄡˉ	shou
ㄕㄡˊ	shou
ㄕㄡˇ	shou
ㄕㄡˋ	shou
ㄕㄡ˙	shou
ㄕㄨ	shu
ㄕㄨˉ	shu
ㄕㄨˊ	shu
ㄕㄨˇ	shu
ㄕㄨˋ	shu
ㄕㄨ˙	shu
ㄕㄨㄚ	shua
ㄕㄨㄚˉ	shua
ㄕㄨㄚˊ	shua
ㄕㄨㄚˇ	shua
ㄕㄨㄚˋ	shua
ㄕㄨㄚ˙	shua
ㄕㄨㄞ	shuai
ㄕㄨㄞˉ	shuai
ㄕㄨㄞˊ	shuai
ㄕㄨㄞˇ	shuai
ㄕㄨㄞˋ	shuai
ㄕㄨㄞ˙	shuai
ㄕㄨㄢ	shuan
ㄕㄨㄢˉ	shuan
ㄕㄨㄢˊ	shuan
ㄕㄨㄢˇ	shuan
ㄕㄨㄢˋ	shuan
ㄕㄨㄢ˙	shuan
ㄕㄨㄤ	shuang
ㄕㄨㄤˉ	shuang
ㄕㄨㄤˊ	shuang
ㄕㄨㄤˇ	shuang
ㄕㄨㄤˋ	shuang
ㄕㄨㄤ˙	shuang
ㄕㄨㄟ	shui
ㄕㄨㄟˉ	shui
ㄕㄨㄟˊ	shui
ㄕㄨㄟˇ	shui
ㄕㄨㄟˋ	shui
ㄕㄨㄟ˙	shui
ㄕㄨㄣ	shun
ㄕㄨㄣˉ	shun
ㄕㄨㄣˊ	shun
ㄕㄨㄣˇ	shun
ㄕㄨㄣˋ	shun
ㄕㄨㄣ˙	shun
ㄕㄨㄥ	shung
ㄕㄨㄥˉ	shung
ㄕㄨㄥˊ	shung
ㄕㄨㄥˇ	shung
ㄕㄨㄥˋ	shung
ㄕㄨㄥ˙	shung
ㄕㄨㄛ	shuo
ㄕㄨㄛˉ	shuo
ㄕㄨㄛˊ	shuo
ㄕㄨㄛˇ	shuo
ㄕㄨㄛˋ	shuo
ㄕㄨㄛ˙	shuo
ㄕㄩ	shv
ㄕㄩˉ	shv
ㄕㄩˊ	shv
ㄕㄩˇ	shv
ㄕㄩˋ	shv
ㄕㄩ˙	shv
ㄕㄩㄝ	shve
ㄕㄩㄝˉ	shve
ㄕㄩㄝˊ	shve
ㄕㄩㄝˇ	shve
ㄕㄩㄝˋ	shve
ㄕㄩㄝ˙	shve
ㄕㄩㄣ	shvn
ㄕㄩㄣˉ	shvn
ㄕㄩㄣˊ	shvn
ㄕㄩㄣˇ	shvn
ㄕㄩㄣˋ	shvn
ㄕㄩㄣ˙	shvn
ㄕㄩㄥ	shvng
ㄕㄩㄥˉ	shvng
ㄕㄩㄥˊ	shvng
ㄕㄩㄥˇ	shvng
ㄕㄩㄥˋ	shvng
ㄕㄩㄥ˙	shvng
ㄕㄩ	shyu
ㄕㄩˉ	shyu
ㄕㄩˊ	shyu
ㄕㄩˇ	shyu
ㄕㄩˋ	shyu
ㄕㄩ˙	shyu
ㄕㄩㄝ	shyue
ㄕㄩㄝˉ	shyue
ㄕㄩㄝˊ	shyue
ㄕㄩㄝˇ	shyue
ㄕㄩㄝˋ	shyue
ㄕㄩㄝ˙	shyue
ㄕㄩㄣ	shyun
ㄕㄩㄣˉ	shyun
ㄕㄩㄣˊ	shyun
ㄕㄩㄣˇ	shyun
ㄕㄩㄣˋ	shyun
ㄕㄩㄣ˙	shyun
ㄕㄩㄥ	shyung
ㄕㄩㄥˉ	shyung
ㄕㄩㄥˊ	shyung
ㄕㄩㄥˇ	shyung
ㄕㄩㄥˋ	shyung
ㄕㄩㄥ˙	shyung
ㄙ	si
ㄙˉ	si
ㄙˊ	si
ㄙˇ	si
ㄙˋ	si
ㄙ˙	si
ㄙㄧ	si
ㄙㄧˉ	si
ㄙㄧˊ	si
ㄙㄧˇ	si
ㄙㄧˋ	si
ㄙㄧ˙	si
ㄙㄧㄚ	sia
ㄙㄧㄚˉ	sia
ㄙㄧㄚˊ	sia
ㄙㄧㄚˇ	sia
ㄙㄧㄚˋ	sia
ㄙㄧㄚ˙	sia
ㄙㄧㄢ	sian
ㄙㄧㄢˉ	sian
ㄙㄧㄢˊ	sian
ㄙㄧㄢˇ	sian
ㄙㄧㄢˋ	sian
ㄙㄧㄢ˙	sian
ㄙㄧㄤ	siang
ㄙㄧㄤˉ	siang
ㄙㄧㄤˊ	siang
ㄙㄧㄤˇ	siang
ㄙㄧㄤˋ	siang
ㄙㄧㄤ˙	siang
ㄙㄧㄠ	siao
ㄙㄧㄠˉ	siao
ㄙㄧㄠˊ	siao
ㄙㄧㄠˇ	siao
ㄙㄧㄠˋ	siao
ㄙㄧㄠ˙	siao
ㄙㄧㄝ	sie
ㄙㄧㄝˉ	sie
ㄙㄧㄝˊ	sie
ㄙㄧㄝˇ	sie
ㄙㄧㄝˋ	sie
ㄙㄧㄝ˙	sie
ㄙㄧㄣ	sin
ㄙㄧㄣˉ	sin
ㄙㄧㄣˊ	sin
ㄙㄧㄣˇ	sin
ㄙㄧㄣˋ	sin
ㄙㄧㄣ˙	sin
ㄙㄧㄥ	sing
ㄙㄧㄥˉ	sing
ㄙㄧㄥˊ	sing
ㄙㄧㄥˇ	sing
ㄙㄧㄥˋ	sing
ㄙㄧㄥ˙	sing
ㄙㄩㄥ	siong
ㄙㄩㄥˉ	siong
ㄙㄩㄥˊ	siong
ㄙㄩㄥˇ	siong
ㄙㄩㄥˋ	siong
ㄙㄩㄥ˙	siong
ㄙㄧㄡ	siou
ㄙㄧㄡˉ	siou
ㄙㄧㄡˊ	siou
ㄙㄧㄡˇ	siou
ㄙㄧㄡˋ	siou
ㄙㄧㄡ˙	siou
ㄙㄧㄡ	siu
ㄙㄧㄡˉ	siu
ㄙㄧㄡˊ	siu
ㄙㄧㄡˇ	siu
ㄙㄧㄡˋ	siu
ㄙㄧㄡ˙	siu
ㄙㄩㄥ	siung
ㄙㄩㄥˉ	siung
ㄙㄩㄥˊ	siung
ㄙㄩㄥˇ	siung
ㄙㄩㄥˋ	siung
ㄙㄩㄥ˙	siung
ㄙㄛ	so
ㄙㄛˉ	so
ㄙㄛˊ	so
ㄙㄛˇ	so
ㄙㄛˋ	so
ㄙㄛ˙	so
ㄙㄨㄥ	song
ㄙㄨㄥˉ	song
ㄙㄨㄥˊ	song
ㄙㄨㄥˇ	song
ㄙㄨㄥˋ	song
ㄙㄨㄥ˙	song
ㄙㄡ	sou
ㄙㄡˉ	sou
ㄙㄡˊ	sou
ㄙㄡˇ	sou
ㄙㄡˋ	sou
ㄙㄡ˙	sou
ㄙㄨ	su
ㄙㄨˉ	su
ㄙㄨˊ	su
ㄙㄨˇ	su
ㄙㄨˋ	su
ㄙㄨ˙	su
ㄙㄨㄚ	sua
ㄙㄨㄚˉ	sua
ㄙㄨㄚˊ	sua
ㄙㄨㄚˇ	sua
ㄙㄨㄚˋ	sua
ㄙㄨㄚ˙	sua
ㄙㄨㄞ	suai
ㄙㄨㄞˉ	suai
ㄙㄨㄞˊ	suai
ㄙㄨㄞˇ	suai
ㄙㄨㄞˋ	suai
ㄙㄨㄞ˙	suai
ㄙㄨㄢ	suan
ㄙㄨㄢˉ	suan
ㄙㄨㄢˊ	suan
ㄙㄨㄢˇ	suan
ㄙㄨㄢˋ	suan
ㄙㄨㄢ˙	suan
ㄙㄨㄤ	suang
ㄙㄨㄤˉ	suang
ㄙㄨㄤˊ	suang
ㄙㄨㄤˇ	suang
ㄙㄨㄤˋ	suang
ㄙㄨㄤ˙	suang
ㄙㄨㄟ	sui
ㄙㄨㄟˉ	sui
ㄙㄨㄟˊ	sui
ㄙㄨㄟˇ	sui
ㄙㄨㄟˋ	sui
ㄙㄨㄟ˙	sui
ㄙㄨㄣ	sun
ㄙㄨㄣˉ	sun
ㄙㄨㄣˊ	sun
ㄙㄨㄣˇ	sun
ㄙㄨㄣˋ	sun
ㄙㄨㄣ˙	sun
ㄙㄨㄥ	sung
ㄙㄨㄥˉ	sung
ㄙㄨㄥˊ	sung
ㄙㄨㄥˇ	sung
ㄙㄨㄥˋ	sung
ㄙㄨㄥ˙	sung
ㄙㄨㄛ	suo
ㄙㄨㄛˉ	suo
ㄙㄨㄛˊ	suo
ㄙㄨㄛˇ	suo
ㄙㄨㄛˋ	suo
ㄙㄨㄛ˙	suo
ㄙㄩ	sv
ㄙㄩˉ	sv
ㄙㄩˊ	sv
ㄙㄩˇ	sv
ㄙㄩˋ	sv
ㄙㄩ˙	sv
ㄙㄩㄝ	sve
ㄙㄩㄝˉ	sve
ㄙㄩㄝˊ	sve
ㄙㄩㄝˇ	sve
ㄙㄩㄝˋ	sve
ㄙㄩㄝ˙	sve
ㄙㄩㄣ	svn
ㄙㄩㄣˉ	svn
ㄙㄩㄣˊ	svn
ㄙㄩㄣˇ	svn
ㄙㄩㄣˋ	svn
ㄙㄩㄣ˙	svn
ㄙㄩㄥ	svng
ㄙㄩㄥˉ	svng
ㄙㄩㄥˊ	svng
ㄙㄩㄥˇ	svng
ㄙㄩㄥˋ	svng
ㄙㄩㄥ˙	svng
ㄙㄩ	syu
ㄙㄩˉ	syu
ㄙㄩˊ	syu
ㄙㄩˇ	syu
ㄙㄩˋ	syu
ㄙㄩ˙	syu
ㄙㄩㄝ	syue
ㄙㄩㄝˉ	syue
ㄙㄩㄝˊ	syue
ㄙㄩㄝˇ	syue
ㄙㄩㄝˋ	syue
ㄙㄩㄝ˙	syue
ㄙㄩㄣ	syun
ㄙㄩㄣˉ	syun
ㄙㄩㄣˊ	syun
ㄙㄩㄣˇ	syun
ㄙㄩㄣˋ	syun
ㄙㄩㄣ˙	syun
ㄙㄩㄥ	syung
ㄙㄩㄥˉ	syung
ㄙㄩㄥˊ	syung
ㄙㄩㄥˇ	syung
ㄙㄩㄥˋ	syung
ㄙㄩㄥ˙	syung
ㄊㄚ	ta
ㄊㄚˉ	ta
ㄊㄚˊ	ta
ㄊㄚˇ	ta
ㄊㄚˋ	ta
ㄊㄚ˙	ta
ㄊㄞ	tai
ㄊㄞˉ	tai
ㄊㄞˊ	tai
ㄊㄞˇ	tai
ㄊㄞˋ	tai
ㄊㄞ˙	tai
ㄊㄢ	tan
ㄊㄢˉ	tan
ㄊㄢˊ	tan
ㄊㄢˇ	tan
ㄊㄢˋ	tan
ㄊㄢ˙	tan
ㄊㄤ	tang
ㄊㄤˉ	tang
ㄊㄤˊ	tang
ㄊㄤˇ	tang
ㄊㄤˋ	tang
ㄊㄤ˙	tang
ㄊㄠ	tao
ㄊㄠˉ	tao
ㄊㄠˊ	tao
ㄊㄠˇ	tao
ㄊㄠˋ	tao
ㄊㄠ˙	tao
ㄊㄜ	te
ㄊㄜˉ	te
ㄊㄜˊ	te
ㄊㄜˇ	te
ㄊㄜˋ	te
ㄊㄜ˙	te
ㄊㄟ	tei
ㄊㄟˉ	tei
ㄊㄟˊ	tei
ㄊㄟˇ	tei
ㄊㄟˋ	tei
ㄊㄟ˙	tei
ㄊㄣ	ten
ㄊㄣˉ	ten
ㄊㄣˊ	ten
ㄊㄣˇ	ten
ㄊㄣˋ	ten
ㄊㄣ˙	ten
ㄊㄥ	teng
ㄊㄥˉ	teng
ㄊㄥˊ	teng
ㄊㄥˇ	teng
ㄊㄥˋ	teng
ㄊㄥ˙	teng
ㄊㄦ	ter
ㄊㄦˉ	ter
ㄊㄦˊ	ter
ㄊㄦˇ	ter
ㄊㄦˋ	ter
ㄊㄦ˙	ter
ㄊㄧ	ti
ㄊㄧˉ	ti
ㄊㄧˊ	ti
ㄊㄧˇ	ti
ㄊㄧˋ	ti
ㄊㄧ˙	ti
ㄊㄧㄚ	tia
ㄊㄧㄚˉ	tia
ㄊㄧㄚˊ	tia
ㄊㄧㄚˇ	tia
ㄊㄧㄚˋ	tia
ㄊㄧㄚ˙	tia
ㄊㄧㄢ	tian
ㄊㄧㄢˉ	tian
ㄊㄧㄢˊ	tian
ㄊㄧㄢˇ	tian
ㄊㄧㄢˋ	tian
ㄊㄧㄢ˙	tian
ㄊㄧㄤ	tiang
ㄊㄧㄤˉ	tiang
ㄊㄧㄤˊ	tiang
ㄊㄧㄤˇ	tiang
ㄊㄧㄤˋ	tiang
ㄊㄧㄤ˙	tiang
ㄊㄧㄠ	tiao
ㄊㄧㄠˉ	tiao
ㄊㄧㄠˊ	tiao
ㄊㄧㄠˇ	tiao
ㄊㄧㄠˋ	tiao
ㄊㄧㄠ˙	tiao
ㄊㄧㄝ	tie
ㄊㄧㄝˉ	tie
ㄊㄧㄝˊ	tie
ㄊㄧㄝˇ	tie
ㄊㄧㄝˋ	tie
ㄊㄧㄝ˙	tie
ㄊㄧㄣ	tin
ㄊㄧㄣˉ	tin
ㄊㄧㄣˊ	tin
ㄊㄧㄣˇ	tin
ㄊㄧㄣˋ	tin
ㄊㄧㄣ˙	tin
ㄊㄧㄥ	ting
ㄊㄧㄥˉ	ting
ㄊㄧㄥˊ	ting
ㄊㄧㄥˇ	ting
ㄊㄧㄥˋ	ting
ㄊㄧㄥ˙	ting
ㄊㄩㄥ	tiong
ㄊㄩㄥˉ	tiong
ㄊㄩㄥˊ	tiong
ㄊㄩㄥˇ	tiong
ㄊㄩㄥˋ	tiong
ㄊㄩㄥ˙	tiong
ㄊㄧㄡ	tiou
ㄊㄧㄡˉ	tiou
ㄊㄧㄡˊ	tiou
ㄊㄧㄡˇ	tiou
ㄊㄧㄡˋ	tiou
ㄊㄧㄡ˙	tiou
ㄊㄧㄡ	tiu
ㄊㄧㄡˉ	tiu
ㄊㄧㄡˊ	tiu
ㄊㄧㄡˇ	tiu
ㄊㄧㄡˋ	tiu
ㄊㄧㄡ˙	tiu
ㄊㄩㄥ	tiung
ㄊㄩㄥˉ	tiung
ㄊㄩㄥˊ	tiung
ㄊㄩㄥˇ	tiung
ㄊㄩㄥˋ	tiung
ㄊㄩㄥ˙	tiung
ㄊㄛ	to
ㄊㄛˉ	to
ㄊㄛˊ	to
ㄊㄛˇ	to
ㄊㄛˋ	to
ㄊㄛ˙	to
ㄊㄨㄥ	tong
ㄊㄨㄥˉ	tong
ㄊㄨㄥˊ	tong
ㄊㄨㄥˇ	tong
ㄊㄨㄥˋ	tong
ㄊㄨㄥ˙	tong
ㄊㄡ	tou
ㄊㄡˉ	tou
ㄊㄡˊ	tou
ㄊㄡˇ	tou
ㄊㄡˋ	tou
ㄊㄡ˙	tou
ㄊㄨ	tu
ㄊㄨˉ	tu
ㄊㄨˊ	tu
ㄊㄨˇ	tu
ㄊㄨˋ	tu
ㄊㄨ˙	tu
ㄊㄨㄚ	tua
ㄊㄨㄚˉ	tua
ㄊㄨㄚˊ	tua
ㄊㄨㄚˇ	tua
ㄊㄨㄚˋ	tua
ㄊㄨㄚ˙	tua
ㄊㄨㄞ	tuai
ㄊㄨㄞˉ	tuai
ㄊㄨㄞˊ	tuai
ㄊㄨㄞˇ	tuai
ㄊㄨㄞˋ	tuai
ㄊㄨㄞ˙	tuai
ㄊㄨㄢ	tuan
ㄊㄨㄢˉ	tuan
ㄊㄨㄢˊ	tuan
ㄊㄨㄢˇ	tuan
ㄊㄨㄢˋ	tuan
ㄊㄨㄢ˙	tuan
ㄊㄨㄤ	tuang
ㄊㄨㄤˉ	tuang
ㄊㄨㄤˊ	tuang
ㄊㄨㄤˇ	tuang
ㄊㄨㄤˋ	tuang
ㄊㄨㄤ˙	tuang
ㄊㄨㄟ	tui
ㄊㄨㄟˉ	tui
ㄊㄨㄟˊ	tui
ㄊㄨㄟˇ	tui
ㄊㄨㄟˋ	tui
ㄊㄨㄟ˙	tui
ㄊㄨㄣ	tun
ㄊㄨㄣˉ	tun
ㄊㄨㄣˊ	tun
ㄊㄨㄣˇ	tun
ㄊㄨㄣˋ	tun
ㄊㄨㄣ˙	tun
ㄊㄨㄥ	tung
ㄊㄨㄥˉ	tung
ㄊㄨㄥˊ	tung
ㄊㄨㄥˇ	tung
ㄊㄨㄥˋ	tung
ㄊㄨㄥ˙	tung
ㄊㄨㄛ	tuo
ㄊㄨㄛˉ	tuo
ㄊㄨㄛˊ	tuo
ㄊㄨㄛˇ	tuo
ㄊㄨㄛˋ	tuo
ㄊㄨㄛ˙	tuo
ㄊㄩ	tv
ㄊㄩˉ	tv
ㄊㄩˊ	tv
ㄊㄩˇ	tv
ㄊㄩˋ	tv
ㄊㄩ˙	tv
ㄊㄩㄝ	tve
ㄊㄩㄝˉ	tve
ㄊㄩㄝˊ	tve
ㄊㄩㄝˇ	tve
ㄊㄩㄝˋ	tve
ㄊㄩㄝ˙	tve
ㄊㄩㄣ	tvn
ㄊㄩㄣˉ	tvn
ㄊㄩㄣˊ	tvn
ㄊㄩㄣˇ	tvn
ㄊㄩㄣˋ	tvn
ㄊㄩㄣ˙	tvn
ㄊㄩㄥ	tvng
ㄊㄩㄥˉ	tvng
ㄊㄩㄥˊ	tvng
ㄊㄩㄥˇ	tvng
ㄊㄩㄥˋ	tvng
ㄊㄩㄥ˙	tvng
ㄊㄩ	tyu
ㄊㄩˉ	tyu
ㄊㄩˊ	tyu
ㄊㄩˇ	tyu
ㄊㄩˋ	tyu
ㄊㄩ˙	tyu
ㄊㄩㄝ	tyue
ㄊㄩㄝˉ	tyue
ㄊㄩㄝˊ	tyue
ㄊㄩㄝˇ	tyue
ㄊㄩㄝˋ	tyue
ㄊㄩㄝ˙	tyue
ㄊㄩㄣ	tyun
ㄊㄩㄣˉ	tyun
ㄊㄩㄣˊ	tyun
ㄊㄩㄣˇ	tyun
ㄊㄩㄣˋ	tyun
ㄊㄩㄣ˙	tyun
ㄊㄩㄥ	tyung
ㄊㄩㄥˉ	tyung
ㄊㄩㄥˊ	tyung
ㄊㄩㄥˇ	tyung
ㄊㄩㄥˋ	tyung
ㄊㄩㄥ˙	tyung
ㄨ	u
ㄨˉ	u
ㄨˊ	u
ㄨˇ	u
ㄨˋ	u
ㄨ˙	u
ㄨㄚ	ua
ㄨㄚˉ	ua
ㄨㄚˊ	ua
ㄨㄚˇ	ua
ㄨㄚˋ	ua
ㄨㄚ˙	ua
ㄨㄞ	uai
ㄨㄞˉ	uai
ㄨㄞˊ	uai
ㄨㄞˇ	uai
ㄨㄞˋ	uai
ㄨㄞ˙	uai
ㄨㄢ	uan
ㄨㄢˉ	uan
ㄨㄢˊ	uan
ㄨㄢˇ	uan
ㄨㄢˋ	uan
ㄨㄢ˙	uan
ㄨㄤ	uang
ㄨㄤˉ	uang
ㄨㄤˊ	uang
ㄨㄤˇ	uang
ㄨㄤˋ	uang
ㄨㄤ˙	uang
ㄨㄟ	ui
ㄨㄟˉ	ui
ㄨㄟˊ	ui
ㄨㄟˇ	ui
ㄨㄟˋ	ui
ㄨㄟ˙	ui
ㄨㄣ	un
ㄨㄣˉ	un
ㄨㄣˊ	un
ㄨㄣˇ	un
ㄨㄣˋ	un
ㄨㄣ˙	un
ㄨㄥ	ung
ㄨㄥˉ	ung
ㄨㄥˊ	ung
ㄨㄥˇ	ung
ㄨㄥˋ	ung
ㄨㄥ˙	ung
ㄨㄛ	uo
ㄨㄛˉ	uo
ㄨㄛˊ	uo
ㄨㄛˇ	uo
ㄨㄛˋ	uo
ㄨㄛ˙	uo
ㄩ	v
ㄩˉ	v
ㄩˊ	v
ㄩˇ	v
ㄩˋ	v
ㄩ˙	v
ㄩㄝ	ve
ㄩㄝˉ	ve
ㄩㄝˊ	ve
ㄩㄝˇ	ve
ㄩㄝˋ	ve
ㄩㄝ˙	ve
ㄩㄣ	vn
ㄩㄣˉ	vn
ㄩㄣˊ	vn
ㄩㄣˇ	vn
ㄩㄣˋ	vn
ㄩㄣ˙	vn
ㄩㄥ	vng
ㄩㄥˉ	vng
ㄩㄥˊ	vng
ㄩㄥˇ	vng
ㄩㄥˋ	vng
ㄩㄥ˙	vng
ㄨㄚ	wa
ㄨㄚˉ	wa
ㄨㄚˊ	wa
ㄨㄚˇ	wa
ㄨㄚˋ	wa
ㄨㄚ˙	wa
ㄨㄞ	wai
ㄨㄞˉ	wai
ㄨㄞˊ	wai
ㄨㄞˇ	wai
ㄨㄞˋ	wai
ㄨㄞ˙	wai
ㄨㄢ	wan
ㄨㄢˉ	wan
ㄨㄢˊ	wan
ㄨㄢˇ	wan
ㄨㄢˋ	wan
ㄨㄢ˙	wan
ㄨㄤ	wang
ㄨㄤˉ	wang
ㄨㄤˊ	wang
ㄨㄤˇ	wang
ㄨㄤˋ	wang
ㄨㄤ˙	wang
ㄨㄟ	wei
ㄨㄟˉ	wei
ㄨㄟˊ	wei
ㄨㄟˇ	wei
ㄨㄟˋ	wei
ㄨㄟ˙	wei
ㄨㄣ	wen
ㄨㄣˉ	wen
ㄨㄣˊ	wen
ㄨㄣˇ	wen
ㄨㄣˋ	wen
ㄨㄣ˙	wen
ㄨㄥ	weng
ㄨㄥˉ	weng
ㄨㄥˊ	weng
ㄨㄥˇ	weng
ㄨㄥˋ	weng
ㄨㄥ˙	weng
ㄨㄛ	wo
ㄨㄛˉ	wo
ㄨㄛˊ	wo
ㄨㄛˇ	wo
ㄨㄛˋ	wo
ㄨㄛ˙	wo
ㄨ	wu
ㄨˉ	wu
ㄨˊ	wu
ㄨˇ	wu
ㄨˋ	wu
ㄨ˙	wu
ㄒㄚ	xa
ㄒㄚˉ	xa
ㄒㄚˊ	xa
ㄒㄚˇ	xa
ㄒㄚˋ	xa
ㄒㄚ˙	xa
ㄒㄞ	xai
ㄒㄞˉ	xai
ㄒㄞˊ	xai
ㄒㄞˇ	xai
ㄒㄞˋ	xai
ㄒㄞ˙	xai
ㄒㄢ	xan
ㄒㄢˉ	xan
ㄒㄢˊ	xan
ㄒㄢˇ	xan
ㄒㄢˋ	xan
ㄒㄢ˙	xan
ㄒㄤ	xang
ㄒㄤˉ	xang
ㄒㄤˊ	xang
ㄒㄤˇ	xang
ㄒㄤˋ	xang
ㄒㄤ˙	xang
ㄒㄠ	xao
ㄒㄠˉ	xao
ㄒㄠˊ	xao
ㄒㄠˇ	xao
ㄒㄠˋ	xao
ㄒㄠ˙	xao
ㄒㄜ	xe
ㄒㄜˉ	xe
ㄒㄜˊ	xe
ㄒㄜˇ	xe
ㄒㄜˋ	xe
ㄒㄜ˙	xe
ㄒㄟ	xei
ㄒㄟˉ	xei
ㄒㄟˊ	xei
ㄒㄟˇ	xei
ㄒㄟˋ	xei
ㄒㄟ˙	xei
ㄒㄣ	xen
ㄒㄣˉ	xen
ㄒㄣˊ	xen
ㄒㄣˇ	xen
ㄒㄣˋ	xen
ㄒㄣ˙	xen
ㄒㄥ	xeng
ㄒㄥˉ	xeng
ㄒㄥˊ	xeng
ㄒㄥˇ	xeng
ㄒㄥˋ	xeng
ㄒㄥ˙	xeng
ㄒㄦ	xer
ㄒㄦˉ	xer
ㄒㄦˊ	xer
ㄒㄦˇ	xer
ㄒㄦˋ	xer
ㄒㄦ˙	xer
ㄒㄧ	xi
ㄒㄧˉ	xi
ㄒㄧˊ	xi
ㄒㄧˇ	xi
ㄒㄧˋ	xi
ㄒㄧ˙	xi
ㄒㄧㄚ	xia
ㄒㄧㄚˉ	xia
ㄒㄧㄚˊ	xia
ㄒㄧㄚˇ	xia
ㄒㄧㄚˋ	xia
ㄒㄧㄚ˙	xia
ㄒㄧㄢ	xian
ㄒㄧㄢˉ	xian
ㄒㄧㄢˊ	xian
ㄒㄧㄢˇ	xian
ㄒㄧㄢˋ	xian
ㄒㄧㄢ˙	xian
ㄒㄧㄤ	xiang
ㄒㄧㄤˉ	xiang
ㄒㄧㄤˊ	xiang
ㄒㄧㄤˇ	xiang
ㄒㄧㄤˋ	xiang
ㄒㄧㄤ˙	xiang
ㄒㄧㄠ	xiao
ㄒㄧㄠˉ	xiao
ㄒㄧㄠˊ	xiao
ㄒㄧㄠˇ	xiao
ㄒㄧㄠˋ	xiao
ㄒㄧㄠ˙	xiao
ㄒㄧㄝ	xie
ㄒㄧㄝˉ	xie
ㄒㄧㄝˊ	xie
ㄒㄧㄝˇ	xie
ㄒㄧㄝˋ	xie
ㄒㄧㄝ˙	xie
ㄒㄧㄣ	xin
ㄒㄧㄣˉ	xin
ㄒㄧㄣˊ	xin
ㄒㄧㄣˇ	xin
ㄒㄧㄣˋ	xin
ㄒㄧㄣ˙	xin
ㄒㄧㄥ	xing
ㄒㄧㄥˉ	xing
ㄒㄧㄥˊ	xing
ㄒㄧㄥˇ	xing
ㄒㄧㄥˋ	xing
ㄒㄧㄥ˙	xing
ㄒㄩㄥ	xiong
ㄒㄩㄥˉ	xiong
ㄒㄩㄥˊ	xiong
ㄒㄩㄥˇ	xiong
ㄒㄩㄥˋ	xiong
ㄒㄩㄥ˙	xiong
ㄒㄧㄡ	xiou
ㄒㄧㄡˉ	xiou
ㄒㄧㄡˊ	xiou
ㄒㄧㄡˇ	xiou
ㄒㄧㄡˋ	xiou
ㄒㄧㄡ˙	xiou
ㄒㄧㄡ	xiu
ㄒㄧㄡˉ	xiu
ㄒㄧㄡˊ	xiu
ㄒㄧㄡˇ	xiu
ㄒㄧㄡˋ	xiu
ㄒㄧㄡ˙	xiu
ㄒㄩㄥ	xiung
ㄒㄩㄥˉ	xiung
ㄒㄩㄥˊ	xiung
ㄒㄩㄥˇ	xiung
ㄒㄩㄥˋ	xiung
ㄒㄩㄥ˙	xiung
ㄒㄛ	xo
ㄒㄛˉ	xo
ㄒㄛˊ	xo
ㄒㄛˇ	xo
ㄒㄛˋ	xo
ㄒㄛ˙	xo
ㄒㄨㄥ	xong
ㄒㄨㄥˉ	xong
ㄒㄨㄥˊ	xong
ㄒㄨㄥˇ	xong
ㄒㄨㄥˋ	xong
ㄒㄨㄥ˙	xong
ㄒㄡ	xou
ㄒㄡˉ	xou
ㄒㄡˊ	xou
ㄒㄡˇ	xou
ㄒㄡˋ	xou
ㄒㄡ˙	xou
ㄒㄨ	xu
ㄒㄨˉ	xu
ㄒㄨˊ	xu
ㄒㄨˇ	xu
ㄒㄨˋ	xu
ㄒㄨ˙	xu
ㄒㄨㄚ	xua
ㄒㄨㄚˉ	xua
ㄒㄨㄚˊ	xua
ㄒㄨㄚˇ	xua
ㄒㄨㄚˋ	xua
ㄒㄨㄚ˙	xua
ㄒㄨㄞ	xuai
ㄒㄨㄞˉ	xuai
ㄒㄨㄞˊ	xuai
ㄒㄨㄞˇ	xuai
ㄒㄨㄞˋ	xuai
ㄒㄨㄞ˙	xuai
ㄒㄨㄢ	xuan
ㄒㄨㄢˉ	xuan
ㄒㄨㄢˊ	xuan
ㄒㄨㄢˇ	xuan
ㄒㄨㄢˋ	xuan
ㄒㄨㄢ˙	xuan
ㄒㄨㄤ	xuang
ㄒㄨㄤˉ	xuang
ㄒㄨㄤˊ	xuang
ㄒㄨㄤˇ	xuang
ㄒㄨㄤˋ	xuang
ㄒㄨㄤ˙	xuang
ㄒㄩㄝ	xue
ㄒㄩㄝˉ	xue
ㄒㄩㄝˊ	xue
ㄒㄩㄝˇ	xue
ㄒㄩㄝˋ	xue
ㄒㄩㄝ˙	xue
ㄒㄨㄟ	xui
ㄒㄨㄟˉ	xui
ㄒㄨㄟˊ	xui
ㄒㄨㄟˇ	xui
ㄒㄨㄟˋ	xui
ㄒㄨㄟ˙	xui
ㄒㄨㄣ	xun
ㄒㄨㄣˉ	xun
ㄒㄨㄣˊ	xun
ㄒㄨㄣˇ	xun
ㄒㄨㄣˋ	xun
ㄒㄨㄣ˙	xun
ㄒㄨㄥ	xung
ㄒㄨㄥˉ	xung
ㄒㄨㄥˊ	xung
ㄒㄨㄥˇ	xung
ㄒㄨㄥˋ	xung
ㄒㄨㄥ˙	xung
ㄒㄨㄛ	xuo
ㄒㄨㄛˉ	xuo
ㄒㄨㄛˊ	xuo
ㄒㄨㄛˇ	xuo
ㄒㄨㄛˋ	xuo
ㄒㄨㄛ˙	xuo
ㄒㄩ	xv
ㄒㄩˉ	xv
ㄒㄩˊ	xv
ㄒㄩˇ	xv
ㄒㄩˋ	xv
ㄒㄩ˙	xv
ㄒㄩㄝ	xve
ㄒㄩㄝˉ	xve
ㄒㄩㄝˊ	xve
ㄒㄩㄝˇ	xve
ㄒㄩㄝˋ	xve
ㄒㄩㄝ˙	xve
ㄒㄩㄣ	xvn
ㄒㄩㄣˉ	xvn
ㄒㄩㄣˊ	xvn
ㄒㄩㄣˇ	xvn
ㄒㄩㄣˋ	xvn
ㄒㄩㄣ˙	xvn
ㄒㄩㄥ	xvng
ㄒㄩㄥˉ	xvng
ㄒㄩㄥˊ	xvng
ㄒㄩㄥˇ	xvng
ㄒㄩㄥˋ	xvng
ㄒㄩㄥ˙	xvng
ㄒㄩ	xyu
ㄒㄩˉ	xyu
ㄒㄩˊ	xyu
ㄒㄩˇ	xyu
ㄒㄩˋ	xyu
ㄒㄩ˙	xyu
ㄒㄩㄝ	xyue
ㄒㄩㄝˉ	xyue
ㄒㄩㄝˊ	xyue
ㄒㄩㄝˇ	xyue
ㄒㄩㄝˋ	xyue
ㄒㄩㄝ˙	xyue
ㄒㄩㄣ	xyun
ㄒㄩㄣˉ	xyun
ㄒㄩㄣˊ	xyun
ㄒㄩㄣˇ	xyun
ㄒㄩㄣˋ	xyun
ㄒㄩㄣ˙	xyun
ㄒㄩㄥ	xyung
ㄒㄩㄥˉ	xyung
ㄒㄩㄥˊ	xyung
ㄒㄩㄥˇ	xyung
ㄒㄩㄥˋ	xyung
ㄒㄩㄥ˙	xyung
ㄧㄚ	ya
ㄧㄚˉ	ya
ㄧㄚˊ	ya
ㄧㄚˇ	ya
ㄧㄚˋ	ya
ㄧㄚ˙	ya
ㄧㄢ	yan
ㄧㄢˉ	yan
ㄧㄢˊ	yan
ㄧㄢˇ	yan
ㄧㄢˋ	yan
ㄧㄢ˙	yan
ㄧㄤ	yang
ㄧㄤˉ	yang
ㄧㄤˊ	yang
ㄧㄤˇ	yang
ㄧㄤˋ	yang
ㄧㄤ˙	yang
ㄧㄠ	yao
ㄧㄠˉ	yao
ㄧㄠˊ	yao
ㄧㄠˇ	yao
ㄧㄠˋ	yao
ㄧㄠ˙	yao
ㄧㄝ	ye
ㄧㄝˉ	ye
ㄧㄝˊ	ye
ㄧㄝˇ	ye
ㄧㄝˋ	ye
ㄧㄝ˙	ye
ㄧ	yi
ㄧˉ	yi
ㄧˊ	yi
ㄧˇ	yi
ㄧˋ	yi
ㄧ˙	yi
ㄧㄣ	yin
ㄧㄣˉ	yin
ㄧㄣˊ	yin
ㄧㄣˇ	yin
ㄧㄣˋ	yin
ㄧㄣ˙	yin
ㄧㄥ	ying
ㄧㄥˉ	ying
ㄧㄥˊ	ying
ㄧㄥˇ	ying
ㄧㄥˋ	ying
ㄧㄥ˙	ying
ㄩㄥ	yong
ㄩㄥˉ	yong
ㄩㄥˊ	yong
ㄩㄥˇ	yong
ㄩㄥˋ	yong
ㄩㄥ˙	yong
ㄧㄡ	you
ㄧㄡˉ	you
ㄧㄡˊ	you
ㄧㄡˇ	you
ㄧㄡˋ	you
ㄧㄡ˙	you
ㄩ	yu
ㄩˉ	yu
ㄩˊ	yu
ㄩˇ	yu
ㄩˋ	yu
ㄩ˙	yu
ㄩㄝ	yue
ㄩㄝˉ	yue
ㄩㄝˊ	yue
ㄩㄝˇ	yue
ㄩㄝˋ	yue
ㄩㄝ˙	yue
ㄩㄣ	yun
ㄩㄣˉ	yun
ㄩㄣˊ	yun
ㄩㄣˇ	yun
ㄩㄣˋ	yun
ㄩㄣ˙	yun
ㄩㄥ	yung
ㄩㄥˉ	yung
ㄩㄥˊ	yung
ㄩㄥˇ	yung
ㄩㄥˋ	yung
ㄩㄥ˙	yung
ㄗㄚ	za
ㄗㄚˉ	za
ㄗㄚˊ	za
ㄗㄚˇ	za
ㄗㄚˋ	za
ㄗㄚ˙	za
ㄗㄞ	zai
ㄗㄞˉ	zai
ㄗㄞˊ	zai
ㄗㄞˇ	zai
ㄗㄞˋ	zai
ㄗㄞ˙	zai
ㄗㄢ	zan
ㄗㄢˉ	zan
ㄗㄢˊ	zan
ㄗㄢˇ	zan
ㄗㄢˋ	zan
ㄗㄢ˙	zan
ㄗㄤ	zang
ㄗㄤˉ	zang
ㄗㄤˊ	zang
ㄗㄤˇ	zang
ㄗㄤˋ	zang
ㄗㄤ˙	zang
ㄗㄠ	zao
ㄗㄠˉ	zao
ㄗㄠˊ	zao
ㄗㄠˇ	zao
ㄗㄠˋ	zao
ㄗㄠ˙	zao
ㄗㄜ	ze
ㄗㄜˉ	ze
ㄗㄜˊ	ze
ㄗㄜˇ	ze
ㄗㄜˋ	ze
ㄗㄜ˙	ze
ㄗㄟ	zei
ㄗㄟˉ	zei
ㄗㄟˊ	zei
ㄗㄟˇ	zei
ㄗㄟˋ	zei
ㄗㄟ˙	zei
ㄗㄣ	zen
ㄗㄣˉ	zen
ㄗㄣˊ	zen
ㄗㄣˇ	zen
ㄗㄣˋ	zen
ㄗㄣ˙	zen
ㄗㄥ	zeng
ㄗㄥˉ	zeng
ㄗㄥˊ	zeng
ㄗㄥˇ	zeng
ㄗㄥˋ	zeng
ㄗㄥ˙	zeng
ㄗㄦ	zer
ㄗㄦˉ	zer
ㄗㄦˊ	zer
ㄗㄦˇ	zer
ㄗㄦˋ	zer
ㄗㄦ˙	zer
ㄓㄚ	zha
ㄓㄚˉ	zha
ㄓㄚˊ	zha
ㄓㄚˇ	zha
ㄓㄚˋ	zha
ㄓㄚ˙	zha
ㄓㄞ	zhai
ㄓㄞˉ	zhai
ㄓㄞˊ	zhai
ㄓㄞˇ	zhai
ㄓㄞˋ	zhai
ㄓㄞ˙	zhai
ㄓㄢ	zhan
ㄓㄢˉ	zhan
ㄓㄢˊ	zhan
ㄓㄢˇ	zhan
ㄓㄢˋ	zhan
ㄓㄢ˙	zhan
ㄓㄤ	zhang
ㄓㄤˉ	zhang
ㄓㄤˊ	zhang
ㄓㄤˇ	zhang
ㄓㄤˋ	zhang
ㄓㄤ˙	zhang
ㄓㄠ	zhao
ㄓㄠˉ	zhao
ㄓㄠˊ	zhao
ㄓㄠˇ	zhao
ㄓㄠˋ	zhao
ㄓㄠ˙	zhao
ㄓㄜ	zhe
ㄓㄜˉ	zhe
ㄓㄜˊ	zhe
ㄓㄜˇ	zhe
ㄓㄜˋ	zhe
ㄓㄜ˙	zhe
ㄓㄟ	zhei
ㄓㄟˉ	zhei
ㄓㄟˊ	zhei
ㄓㄟˇ	zhei
ㄓㄟˋ	zhei
ㄓㄟ˙	zhei
ㄓㄣ	zhen
ㄓㄣˉ	zhen
ㄓㄣˊ	zhen
ㄓㄣˇ	zhen
ㄓㄣˋ	zhen
ㄓㄣ˙	zhen
ㄓㄥ	zheng
ㄓㄥˉ	zheng
ㄓㄥˊ	zheng
ㄓㄥˇ	zheng
ㄓㄥˋ	zheng
ㄓㄥ˙	zheng
ㄓㄦ	zher
ㄓㄦˉ	zher
ㄓㄦˊ	zher
ㄓㄦˇ	zher
ㄓㄦˋ	zher
ㄓㄦ˙	zher
ㄓ	zhi
ㄓˉ	zhi
ㄓˊ	zhi
ㄓˇ	zhi
ㄓˋ	zhi
ㄓ˙	zhi
ㄓㄧ	zhi
ㄓㄧˉ	zhi
ㄓㄧˊ	zhi
ㄓㄧˇ	zhi
ㄓㄧˋ	zhi
ㄓㄧ˙	zhi
ㄓㄧㄚ	zhia
ㄓㄧㄚˉ	zhia
ㄓㄧㄚˊ	zhia
ㄓㄧㄚˇ	zhia
ㄓㄧㄚˋ	zhia
ㄓㄧㄚ˙	zhia
ㄓㄧㄢ	zhian
ㄓㄧㄢˉ	zhian
ㄓㄧㄢˊ	zhian
ㄓㄧㄢˇ	zhian
ㄓㄧㄢˋ	zhian
ㄓㄧㄢ˙	zhian
ㄓㄧㄤ	zhiang
ㄓㄧㄤˉ	zhiang
ㄓㄧㄤˊ	zhiang
ㄓㄧㄤˇ	zhiang
ㄓㄧㄤˋ	zhiang
ㄓㄧㄤ˙	zhiang
ㄓㄧㄠ	zhiao
ㄓㄧㄠˉ	zhiao
ㄓㄧㄠˊ	zhiao
ㄓㄧㄠˇ	zhiao
ㄓㄧㄠˋ	zhiao
ㄓㄧㄠ˙	zhiao
ㄓㄧㄝ	zhie
ㄓㄧㄝˉ	zhie
ㄓㄧㄝˊ	zhie
ㄓㄧㄝˇ	zhie
ㄓㄧㄝˋ	zhie
ㄓㄧㄝ˙	zhie
ㄓㄧㄣ	zhin
ㄓㄧㄣˉ	zhin
ㄓㄧㄣˊ	zhin
ㄓㄧㄣˇ	zhin
ㄓㄧㄣˋ	zhin
ㄓㄧㄣ˙	zhin
ㄓㄧㄥ	zhing
ㄓㄧㄥˉ	zhing
ㄓㄧㄥˊ	zhing
ㄓㄧㄥˇ	zhing
ㄓㄧㄥˋ	zhing
ㄓㄧㄥ˙	zhing
ㄓㄩㄥ	zhiong
ㄓㄩㄥˉ	zhiong
ㄓㄩㄥˊ	zhiong
ㄓㄩㄥˇ	zhiong
ㄓㄩㄥˋ	zhiong
ㄓㄩㄥ˙	zhiong
ㄓㄧㄡ	zhiou
ㄓㄧㄡˉ	zhiou
ㄓㄧㄡˊ	zhiou
ㄓㄧㄡˇ	zhiou
ㄓㄧㄡˋ	zhiou
ㄓㄧㄡ˙	zhiou
ㄓㄧㄡ	zhiu
ㄓㄧㄡˉ	zhiu
ㄓㄧㄡˊ	zhiu
ㄓㄧㄡˇ	zhiu
ㄓㄧㄡˋ	zhiu
ㄓㄧㄡ˙	zhiu
ㄓㄩㄥ	zhiung
ㄓㄩㄥˉ	zhiung
ㄓㄩㄥˊ	zhiung
ㄓㄩㄥˇ	zhiung
ㄓㄩㄥˋ	zhiung
ㄓㄩㄥ˙	zhiung
ㄓㄛ	zho
ㄓㄛˉ	zho
ㄓㄛˊ	zho
ㄓㄛˇ	zho
ㄓㄛˋ	zho
ㄓㄛ˙	zho
ㄓㄨㄥ	zhong
ㄓㄨㄥˉ	zhong
ㄓㄨㄥˊ	zhong
ㄓㄨㄥˇ	zhong
ㄓㄨㄥˋ	zhong
ㄓㄨㄥ˙	zhong
ㄓㄡ	zhou
ㄓㄡˉ	zhou
ㄓㄡˊ	zhou
ㄓㄡˇ	zhou
ㄓㄡˋ	zhou
ㄓㄡ˙	zhou
ㄓㄨ	zhu
ㄓㄨˉ	zhu
ㄓㄨˊ	zhu
ㄓㄨˇ	zhu
ㄓㄨˋ	zhu
ㄓㄨ˙	zhu
ㄓㄨㄚ	zhua
ㄓㄨㄚˉ	zhua
ㄓㄨㄚˊ	zhua
ㄓㄨㄚˇ	zhua
ㄓㄨㄚˋ	zhua
ㄓㄨㄚ˙	zhua
ㄓㄨㄞ	zhuai
ㄓㄨㄞˉ	zhuai
ㄓㄨㄞˊ	zhuai
ㄓㄨㄞˇ	zhuai
ㄓㄨㄞˋ	zhuai
ㄓㄨㄞ˙	zhuai
ㄓㄨㄢ	zhuan
ㄓㄨㄢˉ	zhuan
ㄓㄨㄢˊ	zhuan
ㄓㄨㄢˇ	zhuan
ㄓㄨㄢˋ	zhuan
ㄓㄨㄢ˙	zhuan
ㄓㄨㄤ	zhuang
ㄓㄨㄤˉ	zhuang
ㄓㄨㄤˊ	zhuang
ㄓㄨㄤˇ	zhuang
ㄓㄨㄤˋ	zhuang
ㄓㄨㄤ˙	zhuang
ㄓㄨㄟ	zhui
ㄓㄨㄟˉ	zhui
ㄓㄨㄟˊ	zhui
ㄓㄨㄟˇ	zhui
ㄓㄨㄟˋ	zhui
ㄓㄨㄟ˙	zhui
ㄓㄨㄣ	zhun
ㄓㄨㄣˉ	zhun
ㄓㄨㄣˊ	zhun
ㄓㄨㄣˇ	zhun
ㄓㄨㄣˋ	zhun
ㄓㄨㄣ˙	zhun
ㄓㄨㄥ	zhung
ㄓㄨㄥˉ	zhung
ㄓㄨㄥˊ	zhung
ㄓㄨㄥˇ	zhung
ㄓㄨㄥˋ	zhung
ㄓㄨㄥ˙	zhung
ㄓㄨㄛ	zhuo
ㄓㄨㄛˉ	zhuo
ㄓㄨㄛˊ	zhuo
ㄓㄨㄛˇ	zhuo
ㄓㄨㄛˋ	zhuo
ㄓㄨㄛ˙	zhuo
ㄓㄩ	zhv
ㄓㄩˉ	zhv
ㄓㄩˊ	zhv
ㄓㄩˇ	zhv
ㄓㄩˋ	zhv
ㄓㄩ˙	zhv
ㄓㄩㄝ	zhve
ㄓㄩㄝˉ	zhve
ㄓㄩㄝˊ	zhve
ㄓㄩㄝˇ	zhve
ㄓㄩㄝˋ	zhve
ㄓㄩㄝ˙	zhve
ㄓㄩㄣ	zhvn
ㄓㄩㄣˉ	zhvn
ㄓㄩㄣˊ	zhvn
ㄓㄩㄣˇ	zhvn
ㄓㄩㄣˋ	zhvn
ㄓㄩㄣ˙	zhvn
ㄓㄩㄥ	zhvng
ㄓㄩㄥˉ	zhvng
ㄓㄩㄥˊ	zhvng
ㄓㄩㄥˇ	zhvng
ㄓㄩㄥˋ	zhvng
ㄓㄩㄥ˙	zhvng
ㄓㄩ	zhyu
ㄓㄩˉ	zhyu
ㄓㄩˊ	zhyu
ㄓㄩˇ	zhyu
ㄓㄩˋ	zhyu
ㄓㄩ˙	zhyu
ㄓㄩㄝ	zhyue
ㄓㄩㄝˉ	zhyue
ㄓㄩㄝˊ	zhyue
ㄓㄩㄝˇ	zhyue
ㄓㄩㄝˋ	zhyue
ㄓㄩㄝ˙	zhyue
ㄓㄩㄣ	zhyun
ㄓㄩㄣˉ	zhyun
ㄓㄩㄣˊ	zhyun
ㄓㄩㄣˇ	zhyun
ㄓㄩㄣˋ	zhyun
ㄓㄩㄣ˙	zhyun
ㄓㄩㄥ	zhyung
ㄓㄩㄥˉ	zhyung
ㄓㄩㄥˊ	zhyung
ㄓㄩㄥˇ	zhyung
ㄓㄩㄥˋ	zhyung
ㄓㄩㄥ˙	zhyung
ㄗ	zi
ㄗˉ	zi
ㄗˊ	zi
ㄗˇ	zi
ㄗˋ	zi
ㄗ˙	zi
ㄗㄧ	zi
ㄗㄧˉ	zi
ㄗㄧˊ	zi
ㄗㄧˇ	zi
ㄗㄧˋ	zi
ㄗㄧ˙	zi
ㄗㄧㄚ	zia
ㄗㄧㄚˉ	zia
ㄗㄧㄚˊ	zia
ㄗㄧㄚˇ	zia
ㄗㄧㄚˋ	zia
ㄗㄧㄚ˙	zia
ㄗㄧㄢ	zian
ㄗㄧㄢˉ	zian
ㄗㄧㄢˊ	zian
ㄗㄧㄢˇ	zian
ㄗㄧㄢˋ	zian
ㄗㄧㄢ˙	zian
ㄗㄧㄤ	ziang
ㄗㄧㄤˉ	ziang
ㄗㄧㄤˊ	ziang
ㄗㄧㄤˇ	ziang
ㄗㄧㄤˋ	ziang
ㄗㄧㄤ˙	ziang
ㄗㄧㄠ	ziao
ㄗㄧㄠˉ	ziao
ㄗㄧㄠˊ	ziao
ㄗㄧㄠˇ	ziao
ㄗㄧㄠˋ	ziao
ㄗㄧㄠ˙	ziao
ㄗㄧㄝ	zie
ㄗㄧㄝˉ	zie
ㄗㄧㄝˊ	zie
ㄗㄧㄝˇ	zie
ㄗㄧㄝˋ	zie
ㄗㄧㄝ˙	zie
ㄗㄧㄣ	zin
ㄗㄧㄣˉ	zin
ㄗㄧㄣˊ	zin
ㄗㄧㄣˇ	zin
ㄗㄧㄣˋ	zin
ㄗㄧㄣ˙	zin
ㄗㄧㄥ	zing
ㄗㄧㄥˉ	zing
ㄗㄧㄥˊ	zing
ㄗㄧㄥˇ	zing
ㄗㄧㄥˋ	zing
ㄗㄧㄥ˙	zing
ㄗㄩㄥ	ziong
ㄗㄩㄥˉ	ziong
ㄗㄩㄥˊ	ziong
ㄗㄩㄥˇ	ziong
ㄗㄩㄥˋ	ziong
ㄗㄩㄥ˙	ziong
ㄗㄧㄡ	ziou
ㄗㄧㄡˉ	ziou
ㄗㄧㄡˊ	ziou
ㄗㄧㄡˇ	ziou
ㄗㄧㄡˋ	ziou
ㄗㄧㄡ˙	ziou
ㄗㄧㄡ	ziu
ㄗㄧㄡˉ	ziu
ㄗㄧㄡˊ	ziu
ㄗㄧㄡˇ	ziu
ㄗㄧㄡˋ	ziu
ㄗㄧㄡ˙	ziu
ㄗㄩㄥ	ziung
ㄗㄩㄥˉ	ziung
ㄗㄩㄥˊ	ziung
ㄗㄩㄥˇ	ziung
ㄗㄩㄥˋ	ziung
ㄗㄩㄥ˙	ziung
ㄗㄛ	zo
ㄗㄛˉ	zo
ㄗㄛˊ	zo
ㄗㄛˇ	zo
ㄗㄛˋ	zo
ㄗㄛ˙	zo
ㄗㄨㄥ	zong
ㄗㄨㄥˉ	zong
ㄗㄨㄥˊ	zong
ㄗㄨㄥˇ	zong
ㄗㄨㄥˋ	zong
ㄗㄨㄥ˙	zong
ㄗㄡ	zou
ㄗㄡˉ	zou
ㄗㄡˊ	zou
ㄗㄡˇ	zou
ㄗㄡˋ	zou
ㄗㄡ˙	zou
ㄗㄨ	zu
ㄗㄨˉ	zu
ㄗㄨˊ	zu
ㄗㄨˇ	zu
ㄗㄨˋ	zu
ㄗㄨ˙	zu
ㄗㄨㄚ	zua
ㄗㄨㄚˉ	zua
ㄗㄨㄚˊ	zua
ㄗㄨㄚˇ	zua
ㄗㄨㄚˋ	zua
ㄗㄨㄚ˙	zua
ㄗㄨㄞ	zuai
ㄗㄨㄞˉ	zuai
ㄗㄨㄞˊ	zuai
ㄗㄨㄞˇ	zuai
ㄗㄨㄞˋ	zuai
ㄗㄨㄞ˙	zuai
ㄗㄨㄢ	zuan
ㄗㄨㄢˉ	zuan
ㄗㄨㄢˊ	zuan
ㄗㄨㄢˇ	zuan
ㄗㄨㄢˋ	zuan
ㄗㄨㄢ˙	zuan
ㄗㄨㄤ	zuang
ㄗㄨㄤˉ	zuang
ㄗㄨㄤˊ	zuang
ㄗㄨㄤˇ	zuang
ㄗㄨㄤˋ	zuang
ㄗㄨㄤ˙	zuang
ㄗㄨㄟ	zui
ㄗㄨㄟˉ	zui
ㄗㄨㄟˊ	zui
ㄗㄨㄟˇ	zui
ㄗㄨㄟˋ	zui
ㄗㄨㄟ˙	zui
ㄗㄨㄣ	zun
ㄗㄨㄣˉ	zun
ㄗㄨㄣˊ	zun
ㄗㄨㄣˇ	zun
ㄗㄨㄣˋ	zun
ㄗㄨㄣ˙	zun
ㄗㄨㄥ	zung
ㄗㄨㄥˉ	zung
ㄗㄨㄥˊ	zung
ㄗㄨㄥˇ	zung
ㄗㄨㄥˋ	zung
ㄗㄨㄥ˙	zung
ㄗㄨㄛ	zuo
ㄗㄨㄛˉ	zuo
ㄗㄨㄛˊ	zuo
ㄗㄨㄛˇ	zuo
ㄗㄨㄛˋ	zuo
ㄗㄨㄛ˙	zuo
ㄗㄩ	zv
ㄗㄩˉ	zv
ㄗㄩˊ	zv
ㄗㄩˇ	zv
ㄗㄩˋ	zv
ㄗㄩ˙	zv
ㄗㄩㄝ	zve
ㄗㄩㄝˉ	zve
ㄗㄩㄝˊ	zve
ㄗㄩㄝˇ	zve
ㄗㄩㄝˋ	zve
ㄗㄩㄝ˙	zve
ㄗㄩㄣ	zvn
ㄗㄩㄣˉ	zvn
ㄗㄩㄣˊ	zvn
ㄗㄩㄣˇ	zvn
ㄗㄩㄣˋ	zvn
ㄗㄩㄣ˙	zvn
ㄗㄩㄥ	zvng
ㄗㄩㄥˉ	zvng
ㄗㄩㄥˊ	zvng
ㄗㄩㄥˇ	zvng
ㄗㄩㄥˋ	zvng
ㄗㄩㄥ˙	zvng
ㄗㄩ	zyu
ㄗㄩˉ	zyu
ㄗㄩˊ	zyu
ㄗㄩˇ	zyu
ㄗㄩˋ	zyu
ㄗㄩ˙	zyu
ㄗㄩㄝ	zyue
ㄗㄩㄝˉ	zyue
ㄗㄩㄝˊ	zyue
ㄗㄩㄝˇ	zyue
ㄗㄩㄝˋ	zyue
ㄗㄩㄝ˙	zyue
ㄗㄩㄣ	zyun
ㄗㄩㄣˉ	zyun
ㄗㄩㄣˊ	zyun
ㄗㄩㄣˇ	zyun
ㄗㄩㄣˋ	zyun
ㄗㄩㄣ˙	zyun
ㄗㄩㄥ	zyung
ㄗㄩㄥˉ	zyung
ㄗㄩㄥˊ	zyung
ㄗㄩㄥˇ	zyung
ㄗㄩㄥˋ	zyung
ㄗㄩㄥ˙	zyung
ㄅ	b
ㄆ	p
ㄇ	m
ㄈ	f
ㄉ	d
ㄊ	t
ㄋ	n
ㄌ	l
ㄍ	g
ㄎ	k
ㄏ	h
ㄐ	j
ㄑ	q
ㄒ	x
ㄓ	zh
ㄔ	ch
ㄕ	sh
ㄖ	r
ㄗ	z
ㄘ	c
ㄙ	s
ˉ	m
ˊ	mm
ˇ	mmm
ˋ	mmmm
˙	mmmmm
