아	a
악	ak
앆	akk
앇	aks
안	an
앉	anj
않	anh
앋	at
알	al
앍	alk
앎	alm
앏	alp
앐	als
앑	alt
앒	alp
앓	alh
암	am
압	ap
앖	aps
앗	as
았	ass
앙	ang
앚	aj
앛	ach
앜	ak
앝	at
앞	ap
앟	ah
애	ae
액	aek
앢	aekk
앣	aeks
앤	aen
앥	aenj
앦	aenh
앧	aet
앨	ael
앩	aelk
앪	aelm
앫	aelp
앬	aels
앭	aelt
앮	aelp
앯	aelh
앰	aem
앱	aep
앲	aeps
앳	aes
앴	aess
앵	aeng
앶	aej
앷	aech
앸	aek
앹	aet
앺	aep
앻	aeh
야	ya
약	yak
앾	yakk
앿	yaks
얀	yan
얁	yanj
얂	yanh
얃	yat
얄	yal
얅	yalk
얆	yalm
얇	yalp
얈	yals
얉	yalt
얊	yalp
얋	yalh
얌	yam
얍	yap
얎	yaps
얏	yas
얐	yass
양	yang
얒	yaj
얓	yach
얔	yak
얕	yat
얖	yap
얗	yah
얘	yae
얙	yaek
얚	yaekk
얛	yaeks
얜	yaen
얝	yaenj
얞	yaenh
얟	yaet
얠	yael
얡	yaelk
얢	yaelm
얣	yaelp
얤	yaels
얥	yaelt
얦	yaelp
얧	yaelh
얨	yaem
얩	yaep
얪	yaeps
얫	yaes
얬	yaess
얭	yaeng
얮	yaej
얯	yaech
얰	yaek
얱	yaet
얲	yaep
얳	yaeh
어	eo
억	eok
얶	eokk
얷	eoks
언	eon
얹	eonj
얺	eonh
얻	eot
얼	eol
얽	eolk
얾	eolm
얿	eolp
엀	eols
엁	eolt
엂	eolp
엃	eolh
엄	eom
업	eop
없	eops
엇	eos
었	eoss
엉	eong
엊	eoj
엋	eoch
엌	eok
엍	eot
엎	eop
엏	eoh
에	e
엑	ek
엒	ekk
엓	eks
엔	en
엕	enj
엖	enh
엗	et
엘	el
엙	elk
엚	elm
엛	elp
엜	els
엝	elt
엞	elp
엟	elh
엠	em
엡	ep
엢	eps
엣	es
엤	ess
엥	eng
엦	ej
엧	ech
엨	ek
엩	et
엪	ep
엫	eh
여	yeo
역	yeok
엮	yeokk
엯	yeoks
연	yeon
엱	yeonj
엲	yeonh
엳	yeot
열	yeol
엵	yeolk
엶	yeolm
엷	yeolp
엸	yeols
엹	yeolt
엺	yeolp
엻	yeolh
염	yeom
엽	yeop
엾	yeops
엿	yeos
였	yeoss
영	yeong
옂	yeoj
옃	yeoch
옄	yeok
옅	yeot
옆	yeop
옇	yeoh
예	ye
옉	yek
옊	yekk
옋	yeks
옌	yen
옍	yenj
옎	yenh
옏	yet
옐	yel
옑	yelk
옒	yelm
옓	yelp
옔	yels
옕	yelt
옖	yelp
옗	yelh
옘	yem
옙	yep
옚	yeps
옛	yes
옜	yess
옝	yeng
옞	yej
옟	yech
옠	yek
옡	yet
옢	yep
옣	yeh
오	o
옥	ok
옦	okk
옧	oks
온	on
옩	onj
옪	onh
옫	ot
올	ol
옭	olk
옮	olm
옯	olp
옰	ols
옱	olt
옲	olp
옳	olh
옴	om
옵	op
옶	ops
옷	os
옸	oss
옹	ong
옺	oj
옻	och
옼	ok
옽	ot
옾	op
옿	oh
와	wa
왁	wak
왂	wakk
왃	waks
완	wan
왅	wanj
왆	wanh
왇	wat
왈	wal
왉	walk
왊	walm
왋	walp
왌	wals
왍	walt
왎	walp
왏	walh
왐	wam
왑	wap
왒	waps
왓	was
왔	wass
왕	wang
왖	waj
왗	wach
왘	wak
왙	wat
왚	wap
왛	wah
왜	wae
왝	waek
왞	waekk
왟	waeks
왠	waen
왡	waenj
왢	waenh
왣	waet
왤	wael
왥	waelk
왦	waelm
왧	waelp
왨	waels
왩	waelt
왪	waelp
왫	waelh
왬	waem
왭	waep
왮	waeps
왯	waes
왰	waess
왱	waeng
왲	waej
왳	waech
왴	waek
왵	waet
왶	waep
왷	waeh
외	oe
왹	oek
왺	oekk
왻	oeks
왼	oen
왽	oenj
왾	oenh
왿	oet
욀	oel
욁	oelk
욂	oelm
욃	oelp
욄	oels
욅	oelt
욆	oelp
욇	oelh
욈	oem
욉	oep
욊	oeps
욋	oes
욌	oess
욍	oeng
욎	oej
욏	oech
욐	oek
욑	oet
욒	oep
욓	oeh
요	yo
욕	yok
욖	yokk
욗	yoks
욘	yon
욙	yonj
욚	yonh
욛	yot
욜	yol
욝	yolk
욞	yolm
욟	yolp
욠	yols
욡	yolt
욢	yolp
욣	yolh
욤	yom
욥	yop
욦	yops
욧	yos
욨	yoss
용	yong
욪	yoj
욫	yoch
욬	yok
욭	yot
욮	yop
욯	yoh
우	u
욱	uk
욲	ukk
욳	uks
운	un
욵	unj
욶	unh
욷	ut
울	ul
욹	ulk
욺	ulm
욻	ulp
욼	uls
욽	ult
욾	ulp
욿	ulh
움	um
웁	up
웂	ups
웃	us
웄	uss
웅	ung
웆	uj
웇	uch
웈	uk
웉	ut
웊	up
웋	uh
워	wo
웍	wok
웎	wokk
웏	woks
원	won
웑	wonj
웒	wonh
웓	wot
월	wol
웕	wolk
웖	wolm
웗	wolp
웘	wols
웙	wolt
웚	wolp
웛	wolh
웜	wom
웝	wop
웞	wops
웟	wos
웠	woss
웡	wong
웢	woj
웣	woch
웤	wok
웥	wot
웦	wop
웧	woh
웨	we
웩	wek
웪	wekk
웫	weks
웬	wen
웭	wenj
웮	wenh
웯	wet
웰	wel
웱	welk
웲	welm
웳	welp
웴	wels
웵	welt
웶	welp
웷	welh
웸	wem
웹	wep
웺	weps
웻	wes
웼	wess
웽	weng
웾	wej
웿	wech
윀	wek
윁	wet
윂	wep
윃	weh
위	wi
윅	wik
윆	wikk
윇	wiks
윈	win
윉	winj
윊	winh
윋	wit
윌	wil
윍	wilk
윎	wilm
윏	wilp
윐	wils
윑	wilt
윒	wilp
윓	wilh
윔	wim
윕	wip
윖	wips
윗	wis
윘	wiss
윙	wing
윚	wij
윛	wich
윜	wik
윝	wit
윞	wip
윟	wih
유	yu
육	yuk
윢	yukk
윣	yuks
윤	yun
윥	yunj
윦	yunh
윧	yut
율	yul
윩	yulk
윪	yulm
윫	yulp
윬	yuls
윭	yult
윮	yulp
윯	yulh
윰	yum
윱	yup
윲	yups
윳	yus
윴	yuss
융	yung
윶	yuj
윷	yuch
윸	yuk
윹	yut
윺	yup
윻	yuh
으	eu
윽	euk
윾	eukk
윿	euks
은	eun
읁	eunj
읂	eunh
읃	eut
을	eul
읅	eulk
읆	eulm
읇	eulp
읈	euls
읉	eult
읊	eulp
읋	eulh
음	eum
읍	eup
읎	eups
읏	eus
읐	euss
응	eung
읒	euj
읓	euch
읔	euk
읕	eut
읖	eup
읗	euh
의	ui
읙	uik
읚	uikk
읛	uiks
읜	uin
읝	uinj
읞	uinh
읟	uit
읠	uil
읡	uilk
읢	uilm
읣	uilp
읤	uils
읥	uilt
읦	uilp
읧	uilh
읨	uim
읩	uip
읪	uips
읫	uis
읬	uiss
읭	uing
읮	uij
읯	uich
읰	uik
읱	uit
읲	uip
읳	uih
이	i
익	ik
읶	ikk
읷	iks
인	in
읹	inj
읺	inh
읻	it
일	il
읽	ilk
읾	ilm
읿	ilp
잀	ils
잁	ilt
잂	ilp
잃	ilh
임	im
입	ip
잆	ips
잇	is
있	iss
잉	ing
잊	ij
잋	ich
잌	ik
잍	it
잎	ip
잏	ih
ᄀ	g
ᄁ	kk
ᄂ	n
ᄃ	d
ᄄ	tt
ᄅ	r
ᄆ	m
ᄇ	b
ᄈ	pp
ᄉ	s
ᄊ	ss
ᄋ	ng
ᄌ	j
ᄍ	jj
ᄎ	ch
ᄏ	k
ᄐ	t
ᄑ	p
ᄒ	h
ᄓ	ng
ᄔ	nn
ᄕ	nd
ᄖ	nb
ᄗ	dg
ᄘ	rn
ᄙ	rr
ᄚ	rh
ᄛ	rng
ᄜ	mb
ᄝ	mng
ᄞ	bg
ᄟ	bn
ᄠ	bd
ᄡ	bs
ᄢ	bsg
ᄣ	bsd
ᄤ	bsb
ᄥ	bss
ᄦ	bsj
ᄧ	bj
ᄨ	bch
ᄩ	bt
ᄪ	bp
ᄫ	bng
ᄬ	ppng
ᄭ	sg
ᄮ	sn
ᄯ	sd
ᄰ	sr
ᄱ	sm
ᄲ	sb
ᄳ	sbg
ᄴ	sss
ᄵ	sng
ᄶ	sj
ᄷ	sch
ᄸ	sk
ᄹ	st
ᄺ	sp
ᄻ	sh
ᄼ	s
ᄽ	ss
ᄾ	s
ᄿ	ss
ᅀ	nj
ᅁ	ngg
ᅂ	ngd
ᅃ	ngm
ᅄ	ngb
ᅅ	ngs
ᅆ	ngnj
ᅇ	ngng
ᅈ	ngj
ᅉ	ngch
ᅊ	ngt
ᅋ	ngp
ᅌ	ng
ᅍ	jng
ᅎ	j
ᅏ	jj
ᅐ	j
ᅑ	jj
ᅒ	chk
ᅓ	chh
ᅔ	ch
ᅕ	ch
ᅖ	pb
ᅗ	png
ᅘ	hh
ᅙ	eung
ᅚ	gt
ᅛ	ns
ᅜ	nj
ᅝ	nh
ᅞ	dr
ᅡ	a
ᅢ	ae
ᅣ	ya
ᅤ	yae
ᅥ	eo
ᅦ	e
ᅧ	yeo
ᅨ	ye
ᅩ	o
ᅪ	wa
ᅫ	wae
ᅬ	oe
ᅭ	yo
ᅮ	u
ᅯ	wo
ᅰ	we
ᅱ	wi
ᅲ	yu
ᅳ	eu
ᅴ	ui
ᅵ	i
ᅶ	ao
ᅷ	au
ᅸ	yao
ᅹ	yayo
ᅺ	eoo
ᅻ	eou
ᅼ	eoeu
ᅽ	yeoo
ᅾ	yeou
ᅿ	oeo
ᆀ	oe
ᆁ	oye
ᆂ	oo
ᆃ	ou
ᆄ	yoya
ᆅ	yoyae
ᆆ	yoyeo
ᆇ	yoo
ᆈ	yoi
ᆉ	ua
ᆊ	uae
ᆋ	ueoeu
ᆌ	uye
ᆍ	uu
ᆎ	yua
ᆏ	yueo
ᆐ	yue
ᆑ	yuyeo
ᆒ	yuye
ᆓ	yuu
ᆔ	yui
ᆕ	euu
ᆖ	eueu
ᆗ	uiu
ᆘ	ia
ᆙ	iya
ᆚ	io
ᆛ	iu
ᆜ	ieu
ᆝ	ii
ᆞ	i
ᆟ	ieo
ᆠ	iu
ᆡ	ii
ᆢ	ii
ᆣ	aeu
ᆤ	yau
ᆥ	yeoya
ᆦ	oya
ᆧ	oyae
ᆨ	g
ᆩ	kk
ᆪ	gs
ᆫ	n
ᆬ	nj
ᆭ	nh
ᆮ	d
ᆯ	r
ᆰ	rg
ᆱ	rm
ᆲ	rb
ᆳ	rs
ᆴ	rt
ᆵ	rp
ᆶ	rh
ᆷ	m
ᆸ	b
ᆹ	bs
ᆺ	s
ᆻ	ss
ᆼ	ng
ᆽ	j
ᆾ	ch
ᆿ	k
ᇀ	t
ᇁ	p
ᇂ	h
ᇃ	gr
ᇄ	gsg
ᇅ	ng
ᇆ	nd
ᇇ	ns
ᇈ	nnj
ᇉ	nt
ᇊ	dg
ᇋ	dr
ᇌ	rgs
ᇍ	rn
ᇎ	rd
ᇏ	rdh
ᇐ	rr
ᇑ	rmg
ᇒ	rms
ᇓ	rbs
ᇔ	rbh
ᇕ	rbng
ᇖ	rss
ᇗ	rnj
ᇘ	rk
ᇙ	reung
ᇚ	mg
ᇛ	mr
ᇜ	mb
ᇝ	ms
ᇞ	mss
ᇟ	mnj
ᇠ	mch
ᇡ	mh
ᇢ	mng
ᇣ	br
ᇤ	bp
ᇥ	bh
ᇦ	bng
ᇧ	sg
ᇨ	sd
ᇩ	sr
ᇪ	sb
ᇫ	nj
ᇬ	ngg
ᇭ	ngkk
ᇮ	ngng
ᇯ	ngk
ᇰ	ng
ᇱ	ngs
ᇲ	ngnj
ᇳ	pb
ᇴ	png
ᇵ	hn
ᇶ	hr
ᇷ	hm
ᇸ	hb
ᇹ	eung
ᇺ	gn
ᇻ	gb
ᇼ	gch
ᇽ	gk
ᇾ	gh
ᇿ	nn
ㄱ	g
ㄲ	kk
ㄳ	gs
ㄴ	n
ㄵ	nj
ㄶ	nh
ㄷ	d
ㄸ	tt
ㄹ	r
ㄺ	rg
ㄻ	rm
ㄼ	rb
ㄽ	rs
ㄾ	rt
ㄿ	rp
ㅀ	rh
ㅁ	m
ㅂ	b
ㅃ	pp
ㅄ	ps
ㅅ	s
ㅆ	ss
ㅇ	ng
ㅈ	j
ㅉ	jj
ㅊ	ch
ㅋ	k
ㅌ	t
ㅍ	p
ㅎ	h
ㅏ	a
ㅐ	ae
ㅑ	ya
ㅒ	yae
ㅓ	eo
ㅔ	e
ㅕ	yeo
ㅖ	ye
ㅗ	o
ㅘ	wa
ㅙ	wae
ㅚ	oe
ㅛ	yo
ㅜ	u
ㅝ	wo
ㅞ	we
ㅟ	wi
ㅠ	yu
ㅡ	eu
ㅢ	ui
ㅣ	i
ㅥ	nn
ㅦ	nd
ㅧ	ns
ㅨ	nnj
ㅩ	rgs
ㅪ	rd
ㅫ	rbs
ㅬ	rnj
ㅭ	reung
ㅮ	mb
ㅯ	ms
ㅰ	mnj
ㅱ	mng
ㅲ	bg
ㅳ	bd
ㅴ	bsg
ㅵ	bsd
ㅶ	bj
ㅷ	bt
ㅸ	bng
ㅹ	ppng
ㅺ	sg
ㅻ	sn
ㅼ	sd
ㅽ	sb
ㅾ	sj
ㅿ	nj
ㆀ	ngng
ㆁ	ng
ㆂ	ngs
ㆃ	ngnj
ㆄ	png
ㆅ	hh
ㆆ	eung
ㆇ	yoya
ㆈ	yoyae
ㆉ	yoi
ㆊ	yuyeo
ㆋ	yuye
ㆌ	yui
ㆍ	i
ㆎ	ii
ꥠ	dm
ꥡ	db
ꥢ	ds
ꥣ	dj
ꥤ	rg
ꥥ	rkk
ꥦ	rd
ꥧ	rtt
ꥨ	rm
ꥩ	rb
ꥪ	rpp
ꥫ	rbng
ꥬ	rs
ꥭ	rj
ꥮ	rk
ꥯ	mg
ꥰ	md
ꥱ	ms
ꥲ	bst
ꥳ	bk
ꥴ	bh
ꥵ	ssb
ꥶ	ngr
ꥷ	ngh
ꥸ	jjh
ꥹ	tt
ꥺ	ph
ꥻ	hs
ꥼ	eungeung
ힰ	oyeo
ힱ	ooi
ힲ	yoa
ힳ	yoae
ힴ	yoeo
ힵ	uyeo
ힶ	uii
ힷ	yuae
ힸ	yuo
ힹ	eua
ힺ	eueo
ힻ	eue
ힼ	euo
ힽ	iyao
ힾ	iyae
ힿ	iyeo
ퟀ	iye
ퟁ	ioi
ퟂ	iyo
ퟃ	iyu
ퟄ	ii
ퟅ	ia
ퟆ	ie
ퟋ	nr
ퟌ	nj
ퟍ	tt
ퟎ	ttb
ퟏ	db
ퟐ	ds
ퟑ	dsg
ퟒ	dj
ퟓ	dch
ퟔ	dt
ퟕ	rkk
ퟖ	rgh
ퟗ	rrk
ퟘ	rmh
ퟙ	rbd
ퟚ	rbp
ퟛ	rh
ퟜ	reungh
ퟝ	rng
ퟞ	mn
ퟟ	mnn
ퟠ	mm
ퟡ	mbs
ퟢ	mj
ퟣ	bd
ퟤ	brp
ퟥ	bm
ퟦ	pp
ퟧ	bsd
ퟨ	bj
ퟩ	bch
ퟪ	sm
ퟫ	sbng
ퟬ	ssg
ퟭ	ssd
ퟮ	snj
ퟯ	sj
ퟰ	sch
ퟱ	st
ퟲ	sh
ퟳ	njb
ퟴ	njbng
ퟵ	ngm
ퟶ	ngh
ퟷ	jb
ퟸ	jpp
ퟹ	jj
ퟺ	ps
ퟻ	pt
가	ga
각	gak
갂	gakk
갃	gaks
간	gan
갅	ganj
갆	ganh
갇	gat
갈	gal
갉	galk
갊	galm
갋	galp
갌	gals
갍	galt
갎	galp
갏	galh
감	gam
갑	gap
값	gaps
갓	gas
갔	gass
강	gang
갖	gaj
갗	gach
갘	gak
같	gat
갚	gap
갛	gah
개	gae
객	gaek
갞	gaekk
갟	gaeks
갠	gaen
갡	gaenj
갢	gaenh
갣	gaet
갤	gael
갥	gaelk
갦	gaelm
갧	gaelp
갨	gaels
갩	gaelt
갪	gaelp
갫	gaelh
갬	gaem
갭	gaep
갮	gaeps
갯	gaes
갰	gaess
갱	gaeng
갲	gaej
갳	gaech
갴	gaek
갵	gaet
갶	gaep
갷	gaeh
갸	gya
갹	gyak
갺	gyakk
갻	gyaks
갼	gyan
갽	gyanj
갾	gyanh
갿	gyat
걀	gyal
걁	gyalk
걂	gyalm
걃	gyalp
걄	gyals
걅	gyalt
걆	gyalp
걇	gyalh
걈	gyam
걉	gyap
걊	gyaps
걋	gyas
걌	gyass
걍	gyang
걎	gyaj
걏	gyach
걐	gyak
걑	gyat
걒	gyap
걓	gyah
걔	gyae
걕	gyaek
걖	gyaekk
걗	gyaeks
걘	gyaen
걙	gyaenj
걚	gyaenh
걛	gyaet
걜	gyael
걝	gyaelk
걞	gyaelm
걟	gyaelp
걠	gyaels
걡	gyaelt
걢	gyaelp
걣	gyaelh
걤	gyaem
걥	gyaep
걦	gyaeps
걧	gyaes
걨	gyaess
걩	gyaeng
걪	gyaej
걫	gyaech
걬	gyaek
걭	gyaet
걮	gyaep
걯	gyaeh
거	geo
걱	geok
걲	geokk
걳	geoks
건	geon
걵	geonj
걶	geonh
걷	geot
걸	geol
걹	geolk
걺	geolm
걻	geolp
걼	geols
걽	geolt
걾	geolp
걿	geolh
검	geom
겁	geop
겂	geops
것	geos
겄	geoss
겅	geong
겆	geoj
겇	geoch
겈	geok
겉	geot
겊	geop
겋	geoh
게	ge
겍	gek
겎	gekk
겏	geks
겐	gen
겑	genj
겒	genh
겓	get
겔	gel
겕	gelk
겖	gelm
겗	gelp
겘	gels
겙	gelt
겚	gelp
겛	gelh
겜	gem
겝	gep
겞	geps
겟	ges
겠	gess
겡	geng
겢	gej
겣	gech
겤	gek
겥	get
겦	gep
겧	geh
겨	gyeo
격	gyeok
겪	gyeokk
겫	gyeoks
견	gyeon
겭	gyeonj
겮	gyeonh
겯	gyeot
결	gyeol
겱	gyeolk
겲	gyeolm
겳	gyeolp
겴	gyeols
겵	gyeolt
겶	gyeolp
겷	gyeolh
겸	gyeom
겹	gyeop
겺	gyeops
겻	gyeos
겼	gyeoss
경	gyeong
겾	gyeoj
겿	gyeoch
곀	gyeok
곁	gyeot
곂	gyeop
곃	gyeoh
계	gye
곅	gyek
곆	gyekk
곇	gyeks
곈	gyen
곉	gyenj
곊	gyenh
곋	gyet
곌	gyel
곍	gyelk
곎	gyelm
곏	gyelp
곐	gyels
곑	gyelt
곒	gyelp
곓	gyelh
곔	gyem
곕	gyep
곖	gyeps
곗	gyes
곘	gyess
곙	gyeng
곚	gyej
곛	gyech
곜	gyek
곝	gyet
곞	gyep
곟	gyeh
고	go
곡	gok
곢	gokk
곣	goks
곤	gon
곥	gonj
곦	gonh
곧	got
골	gol
곩	golk
곪	golm
곫	golp
곬	gols
곭	golt
곮	golp
곯	golh
곰	gom
곱	gop
곲	gops
곳	gos
곴	goss
공	gong
곶	goj
곷	goch
곸	gok
곹	got
곺	gop
곻	goh
과	gwa
곽	gwak
곾	gwakk
곿	gwaks
관	gwan
괁	gwanj
괂	gwanh
괃	gwat
괄	gwal
괅	gwalk
괆	gwalm
괇	gwalp
괈	gwals
괉	gwalt
괊	gwalp
괋	gwalh
괌	gwam
괍	gwap
괎	gwaps
괏	gwas
괐	gwass
광	gwang
괒	gwaj
괓	gwach
괔	gwak
괕	gwat
괖	gwap
괗	gwah
괘	gwae
괙	gwaek
괚	gwaekk
괛	gwaeks
괜	gwaen
괝	gwaenj
괞	gwaenh
괟	gwaet
괠	gwael
괡	gwaelk
괢	gwaelm
괣	gwaelp
괤	gwaels
괥	gwaelt
괦	gwaelp
괧	gwaelh
괨	gwaem
괩	gwaep
괪	gwaeps
괫	gwaes
괬	gwaess
괭	gwaeng
괮	gwaej
괯	gwaech
괰	gwaek
괱	gwaet
괲	gwaep
괳	gwaeh
괴	goe
괵	goek
괶	goekk
괷	goeks
괸	goen
괹	goenj
괺	goenh
괻	goet
괼	goel
괽	goelk
괾	goelm
괿	goelp
굀	goels
굁	goelt
굂	goelp
굃	goelh
굄	goem
굅	goep
굆	goeps
굇	goes
굈	goess
굉	goeng
굊	goej
굋	goech
굌	goek
굍	goet
굎	goep
굏	goeh
교	gyo
굑	gyok
굒	gyokk
굓	gyoks
굔	gyon
굕	gyonj
굖	gyonh
굗	gyot
굘	gyol
굙	gyolk
굚	gyolm
굛	gyolp
굜	gyols
굝	gyolt
굞	gyolp
굟	gyolh
굠	gyom
굡	gyop
굢	gyops
굣	gyos
굤	gyoss
굥	gyong
굦	gyoj
굧	gyoch
굨	gyok
굩	gyot
굪	gyop
굫	gyoh
구	gu
국	guk
굮	gukk
굯	guks
군	gun
굱	gunj
굲	gunh
굳	gut
굴	gul
굵	gulk
굶	gulm
굷	gulp
굸	guls
굹	gult
굺	gulp
굻	gulh
굼	gum
굽	gup
굾	gups
굿	gus
궀	guss
궁	gung
궂	guj
궃	guch
궄	guk
궅	gut
궆	gup
궇	guh
궈	gwo
궉	gwok
궊	gwokk
궋	gwoks
권	gwon
궍	gwonj
궎	gwonh
궏	gwot
궐	gwol
궑	gwolk
궒	gwolm
궓	gwolp
궔	gwols
궕	gwolt
궖	gwolp
궗	gwolh
궘	gwom
궙	gwop
궚	gwops
궛	gwos
궜	gwoss
궝	gwong
궞	gwoj
궟	gwoch
궠	gwok
궡	gwot
궢	gwop
궣	gwoh
궤	gwe
궥	gwek
궦	gwekk
궧	gweks
궨	gwen
궩	gwenj
궪	gwenh
궫	gwet
궬	gwel
궭	gwelk
궮	gwelm
궯	gwelp
궰	gwels
궱	gwelt
궲	gwelp
궳	gwelh
궴	gwem
궵	gwep
궶	gweps
궷	gwes
궸	gwess
궹	gweng
궺	gwej
궻	gwech
궼	gwek
궽	gwet
궾	gwep
궿	gweh
귀	gwi
귁	gwik
귂	gwikk
귃	gwiks
귄	gwin
귅	gwinj
귆	gwinh
귇	gwit
귈	gwil
귉	gwilk
귊	gwilm
귋	gwilp
귌	gwils
귍	gwilt
귎	gwilp
귏	gwilh
귐	gwim
귑	gwip
귒	gwips
귓	gwis
귔	gwiss
귕	gwing
귖	gwij
귗	gwich
귘	gwik
귙	gwit
귚	gwip
귛	gwih
규	gyu
귝	gyuk
귞	gyukk
귟	gyuks
균	gyun
귡	gyunj
귢	gyunh
귣	gyut
귤	gyul
귥	gyulk
귦	gyulm
귧	gyulp
귨	gyuls
귩	gyult
귪	gyulp
귫	gyulh
귬	gyum
귭	gyup
귮	gyups
귯	gyus
귰	gyuss
귱	gyung
귲	gyuj
귳	gyuch
귴	gyuk
귵	gyut
귶	gyup
귷	gyuh
그	geu
극	geuk
귺	geukk
귻	geuks
근	geun
귽	geunj
귾	geunh
귿	geut
글	geul
긁	geulk
긂	geulm
긃	geulp
긄	geuls
긅	geult
긆	geulp
긇	geulh
금	geum
급	geup
긊	geups
긋	geus
긌	geuss
긍	geung
긎	geuj
긏	geuch
긐	geuk
긑	geut
긒	geup
긓	geuh
긔	gui
긕	guik
긖	guikk
긗	guiks
긘	guin
긙	guinj
긚	guinh
긛	guit
긜	guil
긝	guilk
긞	guilm
긟	guilp
긠	guils
긡	guilt
긢	guilp
긣	guilh
긤	guim
긥	guip
긦	guips
긧	guis
긨	guiss
긩	guing
긪	guij
긫	guich
긬	guik
긭	guit
긮	guip
긯	guih
기	gi
긱	gik
긲	gikk
긳	giks
긴	gin
긵	ginj
긶	ginh
긷	git
길	gil
긹	gilk
긺	gilm
긻	gilp
긼	gils
긽	gilt
긾	gilp
긿	gilh
김	gim
깁	gip
깂	gips
깃	gis
깄	giss
깅	ging
깆	gij
깇	gich
깈	gik
깉	git
깊	gip
깋	gih
까	kka
깍	kkak
깎	kkakk
깏	kkaks
깐	kkan
깑	kkanj
깒	kkanh
깓	kkat
깔	kkal
깕	kkalk
깖	kkalm
깗	kkalp
깘	kkals
깙	kkalt
깚	kkalp
깛	kkalh
깜	kkam
깝	kkap
깞	kkaps
깟	kkas
깠	kkass
깡	kkang
깢	kkaj
깣	kkach
깤	kkak
깥	kkat
깦	kkap
깧	kkah
깨	kkae
깩月	kkaek
깪	kkaekk
깫	kkaeks
깬	kkaen
깭	kkaenj
깮	kkaenh
깯	kkaet
깰	kkael
깱	kkaelk
깲	kkaelm
깳	kkaelp
깴	kkaels
깵	kkaelt
깶	kkaelp
깷	kkaelh
깸	kkaem
깹	kkaep
깺	kkaeps
깻	kkaes
깼	kkaess
깽	kkaeng
깾	kkaej
깿	kkaech
꺀	kkaek
꺁	kkaet
꺂	kkaep
꺃	kkaeh
꺄	kkya
꺅	kkyak
꺆	kkyakk
꺇	kkyaks
꺈	kkyan
꺉	kkyanj
꺊	kkyanh
꺋	kkyat
꺌	kkyal
꺍	kkyalk
꺎	kkyalm
꺏	kkyalp
꺐	kkyals
꺑	kkyalt
꺒	kkyalp
꺓	kkyalh
꺔	kkyam
꺕	kkyap
꺖	kkyaps
꺗	kkyas
꺘	kkyass
꺙	kkyang
꺚	kkyaj
꺛	kkyach
꺜	kkyak
꺝	kkyat
꺞	kkyap
꺟	kkyah
꺠	kkyae
꺡	kkyaek
꺢	kkyaekk
꺣	kkyaeks
꺤	kkyaen
꺥	kkyaenj
꺦	kkyaenh
꺧	kkyaet
꺨	kkyael
꺩	kkyaelk
꺪	kkyaelm
꺫	kkyaelp
꺬	kkyaels
꺭	kkyaelt
꺮	kkyaelp
꺯	kkyaelh
꺰	kkyaem
꺱	kkyaep
꺲	kkyaeps
꺳	kkyaes
꺴	kkyaess
꺵	kkyaeng
꺶	kkyaej
꺷	kkyaech
꺸	kkyaek
꺹	kkyaet
꺺	kkyaep
꺻	kkyaeh
꺼	kkeo
꺽	kkeok
꺾	kkeokk
꺿	kkeoks
껀	kkeon
껁	kkeonj
껂	kkeonh
껃	kkeot
껄	kkeol
껅	kkeolk
껆	kkeolm
껇	kkeolp
껈	kkeols
껉	kkeolt
껊	kkeolp
껋	kkeolh
껌	kkeom
껍	kkeop
껎	kkeops
껏	kkeos
껐	kkeoss
껑	kkeong
껒	kkeoj
껓	kkeoch
껔	kkeok
껕	kkeot
껖	kkeop
껗	kkeoh
께	kke
껙	kkek
껚	kkekk
껛	kkeks
껜	kken
껝	kkenj
껞	kkenh
껟	kket
껠	kkel
껡	kkelk
껢	kkelm
껣	kkelp
껤	kkels
껥	kkelt
껦	kkelp
껧	kkelh
껨	kkem
껩	kkep
껪	kkeps
껫	kkes
껬	kkess
껭	kkeng
껮	kkej
껯	kkech
껰	kkek
껱	kket
껲	kkep
껳	kkeh
껴	kkyeo
껵	kkyeok
껶	kkyeokk
껷	kkyeoks
껸	kkyeon
껹	kkyeonj
껺	kkyeonh
껻	kkyeot
껼	kkyeol
껽	kkyeolk
껾	kkyeolm
껿	kkyeolp
꼀	kkyeols
꼁	kkyeolt
꼂	kkyeolp
꼃	kkyeolh
꼄	kkyeom
꼅	kkyeop
꼆	kkyeops
꼇	kkyeos
꼈	kkyeoss
꼉	kkyeong
꼊	kkyeoj
꼋	kkyeoch
꼌	kkyeok
꼍	kkyeot
꼎	kkyeop
꼏	kkyeoh
꼐	kkye
꼑	kkyek
꼒	kkyekk
꼓	kkyeks
꼔	kkyen
꼕	kkyenj
꼖	kkyenh
꼗	kkyet
꼘	kkyel
꼙	kkyelk
꼚	kkyelm
꼛	kkyelp
꼜	kkyels
꼝	kkyelt
꼞	kkyelp
꼟	kkyelh
꼠	kkyem
꼡	kkyep
꼢	kkyeps
꼣	kkyes
꼤	kkyess
꼥	kkyeng
꼦	kkyej
꼧	kkyech
꼨	kkyek
꼩	kkyet
꼪	kkyep
꼫	kkyeh
꼬	kko
꼭	kkok
꼮	kkokk
꼯	kkoks
꼰	kkon
꼱	kkonj
꼲	kkonh
꼳	kkot
꼴	kkol
꼵	kkolk
꼶	kkolm
꼷	kkolp
꼸	kkols
꼹	kkolt
꼺	kkolp
꼻	kkolh
꼼	kkom
꼽	kkop
꼾	kkops
꼿	kkos
꽀	kkoss
꽁	kkong
꽂	kkoj
꽃	kkoch
꽄	kkok
꽅	kkot
꽆	kkop
꽇	kkoh
꽈	kkwa
꽉	kkwak
꽊	kkwakk
꽋	kkwaks
꽌	kkwan
꽍	kkwanj
꽎	kkwanh
꽏	kkwat
꽐	kkwal
꽑	kkwalk
꽒	kkwalm
꽓	kkwalp
꽔	kkwals
꽕	kkwalt
꽖	kkwalp
꽗	kkwalh
꽘	kkwam
꽙	kkwap
꽚	kkwaps
꽛	kkwas
꽜	kkwass
꽝	kkwang
꽞	kkwaj
꽟	kkwach
꽠	kkwak
꽡	kkwat
꽢	kkwap
꽣	kkwah
꽤	kkwae
꽥	kkwaek
꽦	kkwaekk
꽧	kkwaeks
꽨	kkwaen
꽩	kkwaenj
꽪	kkwaenh
꽫	kkwaet
꽬	kkwael
꽭	kkwaelk
꽮	kkwaelm
꽯	kkwaelp
꽰	kkwaels
꽱	kkwaelt
꽲	kkwaelp
꽳	kkwaelh
꽴	kkwaem
꽵	kkwaep
꽶	kkwaeps
꽷	kkwaes
꽸	kkwaess
꽹	kkwaeng
꽺	kkwaej
꽻	kkwaech
꽼	kkwaek
꽽	kkwaet
꽾	kkwaep
꽿	kkwaeh
꾀	kkoe
꾁	kkoek
꾂	kkoekk
꾃	kkoeks
꾄	kkoen
꾅	kkoenj
꾆	kkoenh
꾇	kkoet
꾈	kkoel
꾉	kkoelk
꾊	kkoelm
꾋	kkoelp
꾌	kkoels
꾍	kkoelt
꾎	kkoelp
꾏	kkoelh
꾐	kkoem
꾑	kkoep
꾒	kkoeps
꾓	kkoes
꾔	kkoess
꾕	kkoeng
꾖	kkoej
꾗	kkoech
꾘	kkoek
꾙	kkoet
꾚	kkoep
꾛	kkoeh
꾜	kkyo
꾝	kkyok
꾞	kkyokk
꾟	kkyoks
꾠	kkon
꾡	kkyonj
꾢	kkyonh
꾣	kkyot
꾤	kkyol
꾥	kkyolk
꾦	kkyolm
꾧	kkyolp
꾨	kkyols
꾩	kkyolt
꾪	kkyolp
꾫	kkyolh
꾬	kkyom
꾭	kkyop
꾮	kkyops
꾯	kkyos
꾰	kkyoss
꾱	kkyong
꾲	kkyoj
꾳	kkyoch
꾴	kkyok
꾵	kkyot
꾶	kkyop
꾷	kkyoh
꾸	kku
꾹	kkuk
꾺	kkukk
꾻	kkuks
꾼	kkun
꾽	kkunj
꾾	kkunh
꾿	kkut
꿀	kkul
꿁	kkulk
꿂	kkulm
꿃	kkulp
꿄	kkuls
꿅	kkult
꿆	kkulp
꿇	kkulh
꿈	kkum
꿉	kkup
꿊	kkups
꿋	kkus
꿌	kkuss
꿍	kkung
꿎	kkuj
꿏	kkuch
꿐	kkuk
꿑	kkut
꿒	kkup
꿓	kkuh
꿔	kkwo
꿕	kkwok
꿖	kkwokk
꿗	kkwoks
꿘	kkwon
꿙	kkwonj
꿚	kkwonh
꿛	kkwot
꿜	kkwol
꿝	kkwolk
꿞	kkwolm
꿟	kkwolp
꿠	kkwols
꿡	kkwolt
꿢	kkwolp
꿣	kkwolh
꿤	kkwom
꿥	kkwop
꿦	kkwops
꿧	kkwos
꿨	kkwoss
꿩	kkwong
꿪	kkwoj
꿫	kkwoch
꿬	kkwok
꿭	kkwot
꿮	kkwop
꿯	kkwoh
꿰	kkwe
꿱	kkwek
꿲	kkwekk
꿳	kkweks
꿴	kkwen
꿵	kkwenj
꿶	kkwenh
꿷	kkwet
꿸	kkwel
꿹	kkwelk
꿺	kkwelm
꿻	kkwelp
꿼	kkwels
꿽	kkwelt
꿾	kkwelp
꿿	kkwelh
뀀	kkwem
뀁	kkwep
뀂	kkweps
뀃	kkwes
뀄	kkwess
뀅	kkweng
뀆	kkwej
뀇	kkwech
뀈	kkwek
뀉	kkwet
뀊	kkwep
뀋	kkweh
뀌	kkwi
뀍	kkwik
뀎	kkwikk
뀏	kkwiks
뀐	kkwin
뀑	kkwinj
뀒	kkwinh
뀓	kkwit
뀔	kkwil
뀕	kkwilk
뀖	kkwilm
뀗	kkwilp
뀘	kkwils
뀙	kkwilt
뀚	kkwilp
뀛	kkwilh
뀜	kkwim
뀝	kkwip
뀞	kkwips
뀟	kkwis
뀠	kkwiss
뀡	kkwing
뀢	kkwij
뀣	kkwich
뀤	kkwik
뀥	kkwit
뀦	kkwip
뀧	kkwih
뀨	kkyu
뀩	kkyuk
뀪	kkyukk
뀫	kkyuks
뀬	kkyun
뀭	kkyunj
뀮	kkyunh
뀯	kkyut
뀰	kkyul
뀱	kkyulk
뀲	kkyulm
뀳	kkyulp
뀴	kkyuls
뀵	kkyult
뀶	kkyulp
뀷	kkyulh
뀸	kkyum
뀹	kkyup
뀺	kkyups
뀻	kkyus
뀼	kkyuss
뀽	kkyung
뀾	kkyuj
뀿	kkyuch
끀	kkyuk
끁	kkyut
끂	kkyup
끃	kkyuh
끄	kkeu
끅	kkeuk
끆	kkeukk
끇	kkeuks
끈	kkeun
끉	kkeunj
끊	kkeunh
끋	kkeut
끌	kkeul
끍	kkeulk
끎	kkeulm
끏	kkeulp
끐	kkeuls
끑	kkeult
끒	kkeulp
끓	kkeulh
끔	kkeum
끕	kkeup
끖	kkeups
끗	kkeus
끘	kkeuss
끙	kkeung
끚	kkeuj
끛	kkeuch
끜	kkeuk
끝	kkeut
끞	kkeup
끟	kkeuh
끠	kkui
끡	kkuik
끢	kkuikk
끣	kkuiks
끤	kkuin
끥	kkuinj
끦	kkuinh
끧	kkuit
끨	kkuil
끩	kkuilk
끪	kkuilm
끫	kkuilp
끬	kkuils
끭	kkuilt
끮	kkuilp
끯	kkuilh
끰	kkuim
끱	kkuip
끲	kkuips
끳	kkuis
끴	kkuiss
끵	kkuing
끶	kkuij
끷	kkuich
끸	kkuik
끹	kkuit
끺	kkuip
끻	kkuih
끼	kki
끽	kkik
끾	kkikk
끿	kkiks
낀	kkin
낁	kkinj
낂	kkinh
낃	kkit
낄	kkil
낅	kkilk
낆	kkilm
낇	kkilp
낈	kkils
낉	kkilt
낊	kkilp
낋	kkilh
낌	kkim
낍	kkip
낎	kkips
낏	kkis
낐	kkiss
낑	kking
낒	kkij
낓	kkich
낔	kkik
낕	kkit
낖	kkip
낗	kkih
나	na
낙	nak
낚	nakk
낛	naks
난	nan
낝	nanj
낞	nanh
낟	nat
날	nal
낡	nalk
낢	nalm
낣	nalp
낤	nals
낥	nalt
낦	nalp
낧	nalh
남	nam
납	nap
낪	naps
낫	nas
났	nass
낭	nang
낮	naj
낯	nach
낰	nak
낱	nat
낲	nap
낳	nah
내	nae
낵	naek
낶	naekk
낷	naeks
낸	naen
낹	naenj
낺	naenh
낻	naet
낼	nael
낽	naelk
낾	naelm
낿	naelp
냀	naels
냁	naelt
냂	naelp
냃	naelh
냄	naem
냅	naep
냆	naeps
냇	naes
냈	naess
냉	naeng
냊	naej
냋	naech
냌	naek
냍	naet
냎	naep
냏	naeh
냐	nya
냑	nyak
냒	nyakk
냓	nyaks
냔	nyan
냕	nyanj
냖	nyanh
냗	nyat
냘	nyal
냙	nyalk
냚	nyalm
냛	nyalp
냜	nyals
냝	nyalt
냞	nyalp
냟	nyalh
냠	nyam
냡	nyap
냢	nyaps
냣	nyas
냤	nyass
냥	nyang
냦	nyaj
냧	nyach
냨	nyak
냩	nyat
냪	nyap
냫	nyah
냬	nyae
냭	nyaek
냮	nyaekk
냯	nyaeks
냰	nyaen
냱	nyaenj
냲	nyaenh
냳	nyaet
냴	nyael
냵	nyaelk
냶	nyaelm
냷	nyaelp
냸	nyaels
냹	nyaelt
냺	nyaelp
냻	nyaelh
냼	nyaem
냽	nyaep
냾	nyaeps
냿	nyaes
넀	nyaess
넁	nyaeng
넂	nyaej
넃	nyaech
넄	nyaek
넅	nyaet
넆	nyaep
넇	nyaeh
너	neo
넉	neok
넊	neokk
넋	neoks
넌	neon
넍	neonj
넎	neonh
넏	neot
널	neol
넑	neolk
넒	neolm
넓	neolp
넔	neols
넕	neolt
넖	neolp
넗	neolh
넘	neom
넙	neop
넚	neops
넛	neos
넜	neoss
넝	neong
넞	neoj
넟	neoch
넠	neok
넡	neot
넢	neop
넣	neoh
네	ne
넥	nek
넦	nekk
넧	neks
넨	nen
넩	nenj
넪	nenh
넫	net
넬	nel
넭	nelk
넮	nelm
넯	nelp
넰	nels
넱	nelt
넲	nelp
넳	nelh
넴	nem
넵	nep
넶	neps
넷	nes
넸	ness
넹	neng
넺	nej
넻	nech
넼	nek
넽	net
넾	nep
넿	neh
녀	nyeo
녁	nyeok
녂	nyeokk
녃	nyeoks
년	nyeon
녅	nyeonj
녆	nyeonh
녇	nyeot
녈	nyeol
녉	nyeolk
녊	nyeolm
녋	nyeolp
녌	nyeols
녍	nyeolt
녎	nyeolp
녏	nyeolh
념	nyeom
녑	nyeop
녒	nyeops
녓	nyeos
녔	nyeoss
녕	nyeong
녖	nyeoj
녗	nyeoch
녘	nyeok
녙	nyeot
녚	nyeop
녛	nyeoh
녜	nye
녝	nyek
녞	nyekk
녟	nyeks
녠	nyen
녡	nyenj
녢	nyenh
녣	nyet
녤	nyel
녥	nyelk
녦	nyelm
녧	nyelp
녨	nyels
녩	nyelt
녪	nyelp
녫	nyelh
녬	nyem
녭	nyep
녮	nyeps
녯	nyes
녰	nyess
녱	nyeng
녲	nyej
녳	nyech
녴	nyek
녵	nyet
녶	nyep
녷	nyeh
노	no
녹	nok
녺	nokk
녻	noks
논	non
녽	nonj
녾	nonh
녿	not
놀	nol
놁	nolk
놂	nolm
놃	nolp
놄	nols
놅	nolt
놆	nolp
놇	nolh
놈	nom
놉	nop
놊	nops
놋	nos
놌	noss
농	nong
놎	noj
놏	noch
놐	nok
놑	not
높	nop
놓	noh
놔	nwa
놕	nwak
놖	nwakk
놗	nwaks
놘	nwan
놙	nwanj
놚	nwanh
놛	nwat
놜	nwal
놝	nwalk
놞	nwalm
놟	nwalp
놠	nwals
놡	nwalt
놢	nwalp
놣	nwalh
놤	nwam
놥	nwap
놦	nwaps
놧	nwas
놨	nwass
놩	nwang
놪	nwaj
놫	nwach
놬	nwak
놭	nwat
놮	nwap
놯	nwah
놰	nwae
놱	nwaek
놲	nwaekk
놳	nwaeks
놴	nwaen
놵	nwaenj
놶	nwaenh
놷	nwaet
놸	nwael
놹	nwaelk
놺	nwaelm
놻	nwaelp
놼	nwaels
놽	nwaelt
놾	nwaelp
놿	nwaelh
뇀	nwaem
뇁	nwaep
뇂	nwaeps
뇃	nwaes
뇄	nwaess
뇅	nwaeng
뇆	nwaej
뇇	nwaech
뇈	nwaek
뇉	nwaet
뇊	nwaep
뇋	nwaeh
뇌	noe
뇍	noek
뇎	noekk
뇏	noeks
뇐	noen
뇑	noenj
뇒	noenh
뇓	noet
뇔	noel
뇕	noelk
뇖	noelm
뇗	noelp
뇘	noels
뇙	noelt
뇚	noelp
뇛	noelh
뇜	noem
뇝	noep
뇞	noeps
뇟	noes
뇠	noess
뇡	noeng
뇢	noej
뇣	noech
뇤	noek
뇥	noet
뇦	noep
뇧	noeh
뇨	nyo
뇩	nyok
뇪	nyokk
뇫	nyoks
뇬	nyon
뇭	nyonj
뇮	nyonh
뇯	nyot
뇰	nyol
뇱	nyolk
뇲	nyolm
뇳	nyolp
뇴	nyols
뇵	nyolt
뇶	nyolp
뇷	nyolh
뇸	nyom
뇹	nyop
뇺	nyops
뇻	nyos
뇼	nyoss
뇽	nyong
뇾	nyoj
뇿	nyoch
눀	nyok
눁	nyot
눂	nyop
눃	nyoh
누	nu
눅	nuk
눆	nukk
눇	nuks
눈	nun
눉	nunj
눊	nunh
눋	nut
눌	nul
눍	nulk
눎	nulm
눏	nulp
눐	nuls
눑	nult
눒	nulp
눓	nulh
눔	num
눕	nup
눖	nups
눗	nus
눘	nuss
눙	nung
눚	nuj
눛	nuch
눜	nuk
눝	nut
눞	nup
눟	nuh
눠	nwo
눡	nwok
눢	nwokk
눣	nwoks
눤	nwon
눥	nwonj
눦	nwonh
눧	nwot
눨	nwol
눩	nwolk
눪	nwolm
눫	nwolp
눬	nwols
눭	nwolt
눮	nwolp
눯	nwolh
눰	nwom
눱	nwop
눲	nwops
눳	nwos
눴	nwoss
눵	nwong
눶	nwoj
눷	nwoch
눸	nwok
눹	nwot
눺	nwop
눻	nwoh
눼	nwe
눽	nwek
눾	nwekk
눿	nweks
뉀	nwen
뉁	nwenj
뉂	nwenh
뉃	nwet
뉄	nwel
뉅	nwelk
뉆	nwelm
뉇	nwelp
뉈	nwels
뉉	nwelt
뉊	nwelp
뉋	nwelh
뉌	nwem
뉍	nwep
뉎	nweps
뉏	nwes
뉐	nwess
뉑	nweng
뉒	nwej
뉓	nwech
뉔	nwek
뉕	nwet
뉖	nwep
뉗	nweh
뉘	nwi
뉙	nwik
뉚	nwikk
뉛	nwiks
뉜	nwin
뉝	nwinj
뉞	nwinh
뉟	nwit
뉠	nwil
뉡	nwilk
뉢	nwilm
뉣	nwilp
뉤	nwils
뉥	nwilt
뉦	nwilp
뉧	nwilh
뉨	nwim
뉩	nwip
뉪	nwips
뉫	nwis
뉬	nwiss
뉭	nwing
뉮	nwij
뉯	nwich
뉰	nwik
뉱	nwit
뉲	nwip
뉳	nwih
뉴	nyu
뉵	nyuk
뉶	nyukk
뉷	nyuks
뉸	nyun
뉹	nyunj
뉺	nyunh
뉻	nyut
뉼	nyul
뉽	nyulk
뉾	nyulm
뉿	nyulp
늀	nyuls
늁	nyult
늂	nyulp
늃	nyulh
늄	nyum
늅	nyup
늆	nyups
늇	nyus
늈	nyuss
늉	nyung
늊	nyuj
늋	nyuch
늌	nyuk
늍	nyut
늎	nyup
늏	nyuh
느	neu
늑	neuk
늒	neukk
늓	neuks
는	neun
늕	neunj
늖	neunh
늗	neut
늘	neul
늙	neulk
늚	neulm
늛	neulp
늜	neuls
늝	neult
늞	neulp
늟	neulh
늠	neum
늡	neup
늢	neups
늣	neus
늤	neuss
능	neung
늦	neuj
늧	neuch
늨	neuk
늩	neut
늪	neup
늫	neuh
늬	nui
늭	nuik
늮	nuikk
늯	nuiks
늰	nuin
늱	nuinj
늲	nuinh
늳	nuit
늴	nuil
늵	nuilk
늶	nuilm
늷	nuilp
늸	nuils
늹	nuilt
늺	nuilp
늻	nuilh
늼	nuim
늽	nuip
늾	nuips
늿	nuis
닀	nuiss
닁	nuing
닂	nuij
닃	nuich
닄	nuik
닅	nuit
닆	nuip
닇	nuih
니	ni
닉	nik
닊	nikk
닋	niks
닌	nin
닍	ninj
닎	ninh
닏	nit
닐	nil
닑	nilk
닒	nilm
닓	nilp
닔	nils
닕	nilt
닖	nilp
닗	nilh
님	nim
닙	nip
닚	nips
닛	nis
닜	niss
닝	ning
닞	nij
닟	nich
닠	nik
닡	nit
닢	nip
닣	nih
다	da
닥	dak
닦	dakk
닧	daks
단	dan
닩	danj
닪	danh
닫	dat
달	dal
닭	dalk
닮	dalm
닯	dalp
닰	dals
닱	dalt
닲	dalp
닳	dalh
담	dam
답	dap
닶	daps
닷	das
닸	dass
당	dang
닺	daj
닻	dach
닼	dak
닽	dat
닾	dap
닿	dah
대	dae
댁	daek
댂	daekk
댃	daeks
댄	daen
댅	daenj
댆	daenh
댇	daet
댈	dael
댉	daelk
댊	daelm
댋	daelp
댌	daels
댍	daelt
댎	daelp
댏	daelh
댐	daem
댑	daep
댒	daeps
댓	daes
댔	daess
댕	daeng
댖	daej
댗	daech
댘	daek
댙	daet
댚	daep
댛	daeh
댜	dya
댝	dyak
댞	dyakk
댟	dyaks
댠	dyan
댡	dyanj
댢	dyanh
댣	dyat
댤	dyal
댥	dyalk
댦	dyalm
댧	dyalp
댨	dyals
댩	dyalt
댪	dyalp
댫	dyalh
댬	dyam
댭	dyap
댮	dyaps
댯	dyas
댰	dyass
댱	dyang
댲	dyaj
댳	dyach
댴	dyak
댵	dyat
댶	dyap
댷	dyah
댸	dyae
댹	dyaek
댺	dyaekk
댻	dyaeks
댼	dyaen
댽	dyaenj
댾	dyaenh
댿	dyaet
덀	dyeal
덁	dyaelk
덂	dyaelm
덃	dyaelp
덄	dyaels
덅	dyaelt
덆	dyaelp
덇	dyaelh
덈	dyaem
덉	dyaep
덊	dyaeps
덋	dyaes
덌	dyaess
덍	dyaeng
덎	dyaej
덏	dyaech
덐	dyaek
덑	dyaet
덒	dyaep
덓	dyaeh
더	deo
덕	deok
덖	deokk
덗	deoks
던	deon
덙	deonj
덚	deonh
덛	deot
덜	deol
덝	deolk
덞	deolm
덟	deolp
덠	deols
덡	deolt
덢	deolp
덣	deolh
덤	deom
덥	deop
덦	deops
덧	deos
덨	deoss
덩	deong
덪	deoj
덫	deoch
덬	deok
덭	deot
덮	deop
덯	deoh
데	de
덱	dek
덲	dekk
덳	deks
덴	den
덵	denj
덶	denh
덷	det
델	del
덹	delk
덺	delm
덻	delp
덼	dels
덽	delt
덾	delp
덿	delh
뎀	dem
뎁	dep
뎂	deps
뎃	des
뎄	dess
뎅	deng
뎆	dej
뎇	dech
뎈	dek
뎉	det
뎊	dep
뎋	deh
뎌	dyeo
뎍	dyeok
뎎	dyeokk
뎏	dyeoks
뎐	dyeon
뎑	dyeonj
뎒	dyeonh
뎓	dyeot
뎔	dyeol
뎕	dyeolk
뎖	dyeolm
뎗	dyeolp
뎘	dyeols
뎙	dyeolt
뎚	dyeolp
뎛	dyeolh
뎜	dyeom
뎝	dyeop
뎞	dyeops
뎟	dyeos
뎠	dyeoss
뎡	dyeong
뎢	dyeoj
뎣	dyeoch
뎤	dyeok
뎥	dyeot
뎦	dyeop
뎧	dyeoh
뎨	dye
뎩	dyek
뎪	dyekk
뎫	dyeks
뎬	dyen
뎭	dyenj
뎮	dyenh
뎯	dyet
뎰	dyel
뎱	dyelk
뎲	dyelm
뎳	dyelp
뎴	dyels
뎵	dyelt
뎶	dyelp
뎷	dyelh
뎸	dyem
뎹	dyep
뎺	dyeps
뎻	dyes
뎼	dyess
뎽	dyeng
뎾	dyej
뎿	dyech
돀	dyek
돁	dyet
돂	dyep
돃	dyeh
도	do
독	dok
돆	dokk
돇	doks
돈	don
돉	donj
돊	donh
돋	dot
돌	dol
돍	dolk
돎	dolm
돏	dolp
돐	dols
돑	dolt
돒	dolp
돓	dolh
돔	dom
돕	dop
돖	dops
돗	dos
돘	doss
동	dong
돚	doj
돛	doch
돜	dok
돝	dot
돞	dop
돟	doh
돠	dwa
돡	dwak
돢	dwakk
돣	dwaks
돤	dwan
돥	dwanj
돦	dwanh
돧	dwat
돨	dwal
돩	dwalk
돪	dwalm
돫	dwalp
돬	dwals
돭	dwalt
돮	dwalp
돯	dwalh
돰	dwam
돱	dwap
돲	dwaps
돳	dwas
돴	dwass
돵	dwang
돶	dwaj
돷	dwach
돸	dwak
돹	dwat
돺	dwap
돻	dwah
돼	dwae
돽	dwaek
돾	dwaekk
돿	dwaeks
됀	dwaen
됁	dwaenj
됂	dwaenh
됃	dwaet
됄	dwael
됅	dwaelk
됆	dwaelm
됇	dwaelp
됈	dwaels
됉	dwaelt
됊	dwaelp
됋	dwaelh
됌	dwaem
됍	dwaep
됎	dwaeps
됏	dwaes
됐	dwaess
됑	dwaeng
됒	dwaej
됓	dwaech
됔	dwaek
됕	dwaet
됖	dwaep
됗	dwaeh
되	doe
됙	doek
됚	doekk
됛	doeks
된	doen
됝	doenj
됞	doenh
됟	doet
될	doel
됡	doelk
됢	doelm
됣	doelp
됤	doels
됥	doelt
됦	doelp
됧	doelh
됨	doem
됩	doep
됪	doeps
됫	does
됬	doess
됭	doeng
됮	doej
됯	doech
됰	doek
됱	doet
됲	doep
됳	doeh
됴	dyo
됵	dyok
됶	dyokk
됷	dyoks
됸	dyon
됹	dyonj
됺	dyonh
됻	dyot
됼	dyol
됽	dyolk
됾	dyolm
됿	dyolp
둀	dyols
둁	dyolt
둂	dyolp
둃	dyolh
둄	dyom
둅	dyop
둆	dyops
둇	dyos
둈	dyoss
둉	dyong
둊	dyoj
둋	dyoch
둌	dyok
둍	dyot
둎	dyop
둏	dyoh
두	du
둑	duk
둒	dukk
둓	duks
둔	dun
둕	dunj
둖	dunh
둗	dut
둘	dul
둙	dulk
둚	dulm
둛	dulp
둜	duls
둝	dult
둞	dulp
둟	dulh
둠	dum
둡	dup
둢	dups
둣	dus
둤	duss
둥	dung
둦	duj
둧	duch
둨	duk
둩	dut
둪	dup
둫	duh
둬	dwo
둭	dwok
둮	dwokk
둯	dwoks
둰	dwon
둱	dwonj
둲	dwonh
둳	dwot
둴	dwol
둵	dwolk
둶	dwolm
둷	dwolp
둸	dwols
둹	dwolt
둺	dwolp
둻	dwolh
둼	dwom
둽	dwop
둾	dwops
둿	dwos
뒀	dwoss
뒁	dwong
뒂	dwoj
뒃	dwoch
뒄	dwok
뒅	dwot
뒆	dwop
뒇	dwoh
뒈	dwe
뒉	dwek
뒊	dwekk
뒋	dweks
뒌	dwen
뒍	dwenj
뒎	dwenh
뒏	dwet
뒐	dwel
뒑	dwelk
뒒	dwelm
뒓	dwelp
뒔	dwels
뒕	dwelt
뒖	dwelp
뒗	dwelh
뒘	dwem
뒙	dwep
뒚	dweps
뒛	dwes
뒜	dwess
뒝	dweng
뒞	dwej
뒟	dwech
뒠	dwek
뒡	dwet
뒢	dwep
뒣	dweh
뒤	dwi
뒥	dwik
뒦	dwikk
뒧	dwiks
뒨	dwin
뒩	dwinj
뒪	dwinh
뒫	dwit
뒬	dwil
뒭	dwilk
뒮	dwilm
뒯	dwilp
뒰	dwils
뒱	dwilt
뒲	dwilp
뒳	dwilh
뒴	dwim
뒵	dwip
뒶	dwips
뒷	dwis
뒸	dwiss
뒹	dwing
뒺	dwij
뒻	dwich
뒼	dwik
뒽	dwit
뒾	dwip
뒿	dwih
듀	dyu
듁	dyuk
듂	dyukk
듃	dyuks
듄	dyun
듅	dyunj
듆	dyunh
듇	dyut
듈	dyul
듉	dyulk
듊	dyulm
듋	dyulp
듌	dyuls
듍	dyult
듎	dyulp
듏	dyulh
듐	dyum
듑	dyup
듒	dyups
듓	dyus
듔	dyuss
듕	dyung
듖	dyuj
듗	dyuch
듘	dyuk
듙	dyut
듚	dyup
듛	dyuh
드	deu
득	deuk
듞	deukk
듟	deuks
든	deun
듡	deunj
듢	deunh
듣	deut
들	deul
듥	deulk
듦	deulm
듧	deulp
듨	deuls
듩	deult
듪	deulp
듫	deulh
듬	deum
듭	deup
듮	deups
듯	deus
듰	deuss
등	deung
듲	deuj
듳	deuch
듴	deuk
듵	deut
듶	deup
듷	deuh
듸	dui
듹	duik
듺	duikk
듻	duiks
듼	duin
듽	duinj
듾	duinh
듿	duit
딀	duil
딁	duilk
딂	duilm
딃	duilp
딄	duils
딅	duilt
딆	duilp
딇	duilh
딈	duim
딉	duip
딊	duips
딋	duis
딌	duiss
딍	duing
딎	duij
딏	duich
딐	duik
딑	duit
딒	duip
딓	duih
디	di
딕	dik
딖	dikk
딗	diks
딘	din
딙	dinj
딚	dinh
딛	dit
딜	dil
딝	dilk
딞	dilm
딟	dilp
딠	dils
딡	dilt
딢	dilp
딣	dilh
딤	dim
딥	dip
딦	dips
딧	dis
딨	diss
딩	ding
딪	dij
딫	dich
딬	dik
딭	dit
딮	dip
딯	dih
따	tta
딱	ttak
딲	ttakk
딳	ttaks
딴	ttan
딵	ttanj
딶	ttanh
딷	ttat
딸	ttal
딹	ttalk
딺	ttalm
딻	ttalp
딼	ttals
딽	ttalt
딾	ttalp
딿	ttalh
땀	ttam
땁	ttap
땂	ttaps
땃	ttas
땄	ttass
땅	ttang
땆	ttaj
땇	ttach
땈	ttak
땉	ttat
땊	ttap
땋	ttah
때	ttae
땍	ttaek
땎	ttaekk
땏	ttaeks
땐	ttaen
땑	ttaenj
땒	ttaenh
땓	ttaet
땔	ttael
땕	ttaelk
땖	ttaelm
땗	ttaelp
땘	ttaels
땙	ttaelt
땚	ttaelp
땛	ttaelh
땜	ttaem
땝	ttaep
땞	ttaeps
땟	ttaes
땠	ttaess
땡	ttaeng
땢	ttaej
땣	ttaech
땤	ttaek
땥	ttaet
땦	ttaep
땧	ttaeh
땨	ttya
땩	ttyak
땪	ttyakk
땫	ttyaks
땬	ttyan
땭	ttyanj
땮	ttyanh
땯	ttyat
땰	ttyal
땱	ttyalk
땲	ttyalm
땳	ttyalp
땴	ttyals
땵	ttyalt
땶	ttyalp
땷	ttyalh
땸	ttyam
땹	ttyap
땺	ttyaps
땻	ttyas
땼	ttyass
땽	ttyang
땾	ttyaj
땿	ttyach
떀	ttyak
떁	ttyat
떂	ttyap
떃	ttyah
떄	ttyae
떅	ttyaek
떆	ttyaekk
떇	ttyaeks
떈	ttyaen
떉	ttyaenj
떊	ttyaenh
떋	ttyaet
떌	ttyael
떍	ttyaelk
떎	ttyaelm
떏	ttyaelp
떐	ttyaels
떑	ttyaelt
떒	ttyaelp
떓	ttyaelh
떔	ttyaem
떕	ttyaep
떖	ttyaeps
떗	ttyaes
떘	ttyaess
떙	ttyaeng
떚	ttyaej
떛	ttyaech
떜	ttyaek
떝	ttyaet
떞	ttyaep
떟	ttyaeh
떠	tteo
떡	tteok
떢	tteokk
떣	tteoks
떤	tteon
떥	tteonj
떦	tteonh
떧	tteot
떨	tteol
떩	tteolk
떪	tteolm
떫	tteolp
떬	tteols
떭	tteolt
떮	tteolp
떯	tteolh
떰	tteom
떱	tteop
떲	tteops
떳	tteos
떴	tteoss
떵	tteong
떶	tteoj
떷	tteoch
떸	tteok
떹	tteot
떺	tteop
떻	tteoh
떼	tte
떽	ttek
떾	ttekk
떿	tteks
뗀	tten
뗁	ttenj
뗂	ttenh
뗃	ttet
뗄	ttel
뗅	ttelk
뗆	ttelm
뗇	ttelp
뗈	ttels
뗉	ttelt
뗊	ttelp
뗋	ttelh
뗌	ttem
뗍	ttep
뗎	tteps
뗏	ttes
뗐	ttess
뗑	tteng
뗒	ttej
뗓	ttech
뗔	ttek
뗕	ttet
뗖	ttep
뗗	tteh
뗘	ttyeo
뗙	ttyeok
뗚	ttyeokk
뗛	ttyeoks
뗜	ttyeon
뗝	ttyeonj
뗞	ttyeonh
뗟	ttyeot
뗠	ttyeol
뗡	ttyeolk
뗢	ttyeolm
뗣	ttyeolp
뗤	ttyeols
뗥	ttyeolt
뗦	ttyeolp
뗧	ttyeolh
뗨	ttyeom
뗩	ttyeop
뗪	ttyeops
뗫	ttyeos
뗬	ttyeoss
뗭	ttyeong
뗮	ttyeoj
뗯	ttyeoch
뗰	ttyeok
뗱	ttyeot
뗲	ttyeop
뗳	ttyeoh
뗴	ttye
뗵	ttyek
뗶	ttyekk
뗷	ttyeks
뗸	ttyen
뗹	ttyenj
뗺	ttyenh
뗻	ttyet
뗼	ttyel
뗽	ttyelk
뗾	ttyelm
뗿	ttyelp
똀	ttyels
똁	ttyelt
똂	ttyelp
똃	ttyelh
똄	ttyem
똅	ttyep
똆	ttyeps
똇	ttyes
똈	ttyess
똉	ttyeng
똊	ttyej
똋	ttyech
똌	ttyek
똍	ttyet
똎	ttyep
똏	ttyeh
또	tto
똑	ttok
똒	ttokk
똓	ttoks
똔	tton
똕	ttonj
똖	ttonh
똗	ttot
똘	ttol
똙	ttolk
똚	ttolm
똛	ttolp
똜	ttols
똝	ttolt
똞	ttolp
똟	ttolh
똠	ttom
똡	ttop
똢	ttops
똣	ttos
똤	ttoss
똥	ttong
똦	ttoj
똧	ttoch
똨	ttok
똩	ttot
똪	ttop
똫	ttoh
똬	ttwa
똭	ttwak
똮	ttwakk
똯	ttwaks
똰	ttwan
똱	ttwanj
똲	ttwanh
똳	ttwat
똴	ttwal
똵	ttwalk
똶	ttwalm
똷	ttwalp
똸	ttwals
똹	ttwalt
똺	ttwalp
똻	ttwalh
똼	ttwam
똽	ttwap
똾	ttwaps
똿	ttwas
뙀	ttwass
뙁	ttwang
뙂	ttwaj
뙃	ttwach
뙄	ttwak
뙅	ttwat
뙆	ttwap
뙇	ttwah
뙈	ttwae
뙉	ttwaek
뙊	ttwaekk
뙋	ttwaeks
뙌	ttwaen
뙍	ttwaenj
뙎	ttwaenh
뙏	ttwaet
뙐	ttwael
뙑	ttwaelk
뙒	ttwaelm
뙓	ttwaelp
뙔	ttwaels
뙕	ttwaelt
뙖	ttwaelp
뙗	ttwaelh
뙘	ttwaem
뙙	ttwaep
뙚	ttwaeps
뙛	ttwaes
뙜	ttwaess
뙝	ttwaeng
뙞	ttwaej
뙟	ttwaech
뙠	ttwaek
뙡	ttwaet
뙢	ttwaep
뙣	ttwaeh
뙤	ttoe
뙥	ttoek
뙦	ttoekk
뙧	ttoeks
뙨	ttoen
뙩	ttoenj
뙪	ttoenh
뙫	ttoet
뙬	ttoel
뙭	ttoelk
뙮	ttoelm
뙯	ttoelp
뙰	ttoels
뙱	ttoelt
뙲	ttoelp
뙳	ttoelh
뙴	ttoem
뙵	ttoep
뙶	ttoeps
뙷	ttoes
뙸	ttoess
뙹	ttoeng
뙺	ttoej
뙻	ttoech
뙼	ttoek
뙽	ttoet
뙾	ttoep
뙿	ttoeh
뚀	ttyo
뚁	ttyok
뚂	ttyokk
뚃	ttyoks
뚄	ttyon
뚅	ttyonj
뚆	ttyonh
뚇	ttyot
뚈	ttyol
뚉	ttyolk
뚊	ttyolm
뚋	ttyolp
뚌	ttyols
뚍	ttyolt
뚎	ttyolp
뚏	ttyolh
뚐	ttyom
뚑	ttyop
뚒	ttyops
뚓	ttyos
뚔	ttyoss
뚕	ttyong
뚖	ttyoj
뚗	ttyoch
뚘	ttyok
뚙	ttyot
뚚	ttyop
뚛	ttyoh
뚜	ttu
뚝	ttuk
뚞	ttukk
뚟	ttuks
뚠	ttun
뚡	ttunj
뚢	ttunh
뚣	ttut
뚤	ttul
뚥	ttulk
뚦	ttulm
뚧	ttulp
뚨	ttuls
뚩	ttult
뚪	ttulp
뚫	ttulh
뚬	ttum
뚭	ttup
뚮	ttups
뚯	ttus
뚰	ttuss
뚱	ttung
뚲	ttuj
뚳	ttuch
뚴	ttuk
뚵	ttut
뚶	ttup
뚷	ttuh
뚸	ttwo
뚹	ttwok
뚺	ttwokk
뚻	ttwoks
뚼	ttwon
뚽	ttwonj
뚾	ttwonh
뚿	ttwot
뛀	ttwol
뛁	ttwolk
뛂	ttwolm
뛃	ttwolp
뛄	ttwols
뛅	ttwolt
뛆	ttwolp
뛇	ttwolh
뛈	ttwom
뛉	ttwop
뛊	ttwops
뛋	ttwos
뛌	ttwoss
뛍	ttwong
뛎	ttwoj
뛏	ttwoch
뛐	ttwok
뛑	ttwot
뛒	ttwop
뛓	ttwoh
뛔	ttwe
뛕	ttwek
뛖	ttwekk
뛗	ttweks
뛘	ttwen
뛙	ttwenj
뛚	ttwenh
뛛	ttwet
뛜	ttwel
뛝	ttwelk
뛞	ttwelm
뛟	ttwelp
뛠	ttwels
뛡	ttwelt
뛢	ttwelp
뛣	ttwelh
뛤	ttwem
뛥	ttwep
뛦	ttweps
뛧	ttwes
뛨	ttwess
뛩	ttweng
뛪	ttwej
뛫	ttwech
뛬	ttwek
뛭	ttwet
뛮	ttwep
뛯	ttweh
뛰	ttwi
뛱	ttwik
뛲	ttwikk
뛳	ttwiks
뛴	ttwin
뛵	ttwinj
뛶	ttwinh
뛷	ttwit
뛸	ttwil
뛹	ttwilk
뛺	ttwilm
뛻	ttwilp
뛼	ttwils
뛽	ttwilt
뛾	ttwilp
뛿	ttwilh
뜀	ttwim
뜁	ttwip
뜂	ttwips
뜃	ttwis
뜄	ttwiss
뜅	ttwing
뜆	ttwij
뜇	ttwich
뜈	ttwik
뜉	ttwit
뜊	ttwip
뜋	ttwih
뜌	ttyu
뜍	ttyuk
뜎	ttyukk
뜏	ttyuks
뜐	ttyun
뜑	ttyunj
뜒	ttyunh
뜓	ttyut
뜔	ttyul
뜕	ttyulk
뜖	ttyulm
뜗	ttyulp
뜘	ttyuls
뜙	ttyult
뜚	ttyulp
뜛	ttyulh
뜜	ttyum
뜝	ttyup
뜞	ttyups
뜟	ttyus
뜠	ttyuss
뜡	ttyung
뜢	ttyuj
뜣	ttyuch
뜤	ttyuk
뜥	ttyut
뜦	ttyup
뜧	ttyuh
뜨	tteu
뜩	tteuk
뜪	tteukk
뜫	tteuks
뜬	tteun
뜭	tteunj
뜮	tteunh
뜯	tteut
뜰	tteul
뜱	tteulk
뜲	tteulm
뜳	tteulp
뜴	tteuls
뜵	tteult
뜶	tteulp
뜷	tteulh
뜸	tteum
뜹	tteup
뜺	tteups
뜻	tteus
뜼	tteuss
뜽	tteung
뜾	tteuj
뜿	tteuch
띀	tteuk
띁	tteut
띂	tteup
띃	tteuh
띄	ttui
띅	ttuik
띆	ttuikk
띇	ttuiks
띈	ttuin
띉	ttuinj
띊	ttuinh
띋	ttuit
띌	ttuil
띍	ttuilk
띎	ttuilm
띏	ttuilp
띐	ttuils
띑	ttuilt
띒	ttuilp
띓	ttuilh
띔	ttuim
띕	ttuip
띖	ttuips
띗	ttuis
띘	ttuiss
띙	ttuing
띚	ttuij
띛	ttuich
띜	ttuik
띝	ttuit
띞	ttuip
띟	ttuih
띠	tti
띡	ttik
띢	ttikk
띣	ttiks
띤	ttin
띥	ttinj
띦	ttinh
띧	ttit
띨	ttil
띩	ttilk
띪	ttilm
띫	ttilp
띬	ttils
띭	ttilt
띮	ttilp
띯	ttilh
띰	ttim
띱	ttip
띲	ttips
띳	ttis
띴	ttiss
띵	tting
띶	ttij
띷	ttich
띸	ttik
띹	ttit
띺	ttip
띻	ttih
라	ra
락	rak
띾	rakk
띿	raks
란	ran
랁	ranj
랂	ranh
랃	rat
랄	ral
랅	ralk
랆	ralm
랇	ralp
랈	rals
랉	ralt
랊	ralp
랋	ralh
람	ram
랍	rap
랎	raps
랏	ras
랐	rass
랑	rang
랒	raj
랓	rach
랔	rak
랕	rat
랖	rap
랗	rah
래	rae
랙	raek
랚	raekk
랛	raeks
랜	raen
랝	raenj
랞	raenh
랟	raet
랠	rael
랡	raelk
랢	raelm
랣	raelp
랤	raels
랥	raelt
랦	raelp
랧	raelh
램	raem
랩	raep
랪	raeps
랫	raes
랬	raess
랭	raeng
랮	raej
랯	raech
랰	raek
랱	raet
랲	raep
랳	raeh
랴	rya
략	ryak
랶	ryakk
랷	ryaks
랸	ryan
랹	ryanj
랺	ryanh
랻	ryat
랼	ryal
랽	ryalk
랾	ryalm
랿	ryalp
럀	ryals
럁	ryalt
럂	ryalp
럃	ryalh
럄	ryam
럅	ryap
럆	ryaps
럇	ryas
럈	ryass
량	ryang
럊	ryaj
럋	ryach
럌	ryak
럍	ryat
럎	ryap
럏	ryah
럐	ryae
럑	ryaek
럒	ryaekk
럓	ryaeks
럔	ryaen
럕	ryaenj
럖	ryaenh
럗	ryaet
럘	ryael
럙	ryaelk
럚	ryaelm
럛	ryaelp
럜	ryaels
럝	ryaelt
럞	ryaelp
럟	ryaelh
럠	ryaem
럡	ryaep
럢	ryaeps
럣	ryaes
럤	ryaess
럥	ryaeng
럦	ryaej
럧	ryaech
럨	ryaek
럩	ryaet
럪	ryaep
럫	ryaeh
러	reo
럭	reok
럮	reokk
럯	reoks
런	reon
럱	reonj
럲	reonh
럳	reot
럴	reol
럵	reolk
럶	reolm
럷	reolp
럸	reols
럹	reolt
럺	reolp
럻	reolh
럼	reom
럽	reop
럾	reops
럿	reos
렀	reoss
렁	reong
렂	reoj
렃	reoch
렄	reok
렅	reot
렆	reop
렇	reoh
레	re
렉	rek
렊	rekk
렋	reks
렌	ren
렍	renj
렎	renh
렏	ret
렐	rel
렑	relk
렒	relm
렓	relp
렔	rels
렕	relt
렖	relp
렗	relh
렘	rem
렙	rep
렚	reps
렛	res
렜	ress
렝	reng
렞	rej
렟	rech
렠	rek
렡	ret
렢	rep
렣	reh
려	ryeo
력	ryeok
렦	ryeokk
렧	ryeoks
련	ryeon
렩	ryeonj
렪	ryeonh
렫	ryeot
렬	ryeol
렭	ryeolk
렮	ryeolm
렯	ryeolp
렰	ryeols
렱	ryeolt
렲	ryeolp
렳	ryeolh
렴	ryeom
렵	ryeop
렶	ryeops
렷	ryeos
렸	ryeoss
령	ryeong
렺	ryeoj
렻	ryeoch
렼	ryeok
렽	ryeot
렾	ryeop
렿	ryeoh
례	rye
롁	ryek
롂	ryekk
롃	ryeks
롄	ryen
롅	ryenj
롆	ryenh
롇	ryet
롈	ryel
롉	ryelk
롊	ryelm
롋	ryelp
롌	ryels
롍	ryelt
롎	ryelp
롏	ryelh
롐	ryem
롑	ryep
롒	ryeps
롓	ryes
롔	ryess
롕	ryeng
롖	ryej
롗	ryech
롘	ryek
롙	ryet
롚	ryep
롛	ryeh
로	ro
록	rok
롞	rokk
롟	roks
론	ron
롡	ronj
롢	ronh
롣	rot
롤	rol
롥	rolk
롦	rolm
롧	rolp
롨	rols
롩	rolt
롪	rolp
롫	rolh
롬	rom
롭	rop
롮	rops
롯	ros
롰	ross
롱	rong
롲	roj
롳	roch
롴	rok
롵	rot
롶	rop
롷	roh
롸	rwa
롹	rwak
롺	rwakk
롻	rwaks
롼	rwan
롽	rwanj
롾	rwanh
롿	rwat
뢀	rwal
뢁	rwalk
뢂	rwalm
뢃	rwalp
뢄	rwals
뢅	rwalt
뢆	rwalp
뢇	rwalh
뢈	rwam
뢉	rwap
뢊	rwaps
뢋	rwas
뢌	rwass
뢍	rwang
뢎	rwaj
뢏	rwach
뢐	rwak
뢑	rwat
뢒	rwap
뢓	rwah
뢔	rwae
뢕	rwaek
뢖	rwaekk
뢗	rwaeks
뢘	rwaen
뢙	rwaenj
뢚	rwaenh
뢛	rwaent
뢜	rwael
뢝	rwaelk
뢞	rwaelm
뢟	rwaelp
뢠	rwaels
뢡	rwaelt
뢢	rwaelp
뢣	rwaelh
뢤	rwaem
뢥	rwaep
뢦	rwaeps
뢧	rwaes
뢨	rwaess
뢩	rwaeng
뢪	rwaej
뢫	rwaech
뢬	rwaek
뢭	rwaet
뢮	rwaep
뢯	rwaeh
뢰	roe
뢱	roek
뢲	roekk
뢳	roeks
뢴	roen
뢵	roenj
뢶	roenh
뢷	roet
뢸	roel
뢹	roelk
뢺	roelm
뢻	roelp
뢼	roels
뢽	roelt
뢾	roelp
뢿	roelh
룀	roem
룁	roep
룂	roeps
룃	roes
룄	roess
룅	roeng
룆	roej
룇	roech
룈	roek
룉	roet
룊	roep
룋	roeh
료	ryo
룍	ryok
룎	ryokk
룏	ryoks
룐	ryon
룑	ryonj
룒	ryonh
룓	ryot
룔	ryol
룕	ryolk
룖	ryolm
룗	ryolp
룘	ryols
룙	ryolt
룚	ryolp
룛	ryolh
룜	ryom
룝	ryop
룞	ryops
룟	ryos
룠	ryoss
룡	ryong
룢	ryoj
룣	ryoch
룤	ryok
룥	ryot
룦	ryop
룧	ryoh
루	ru
룩	ruk
룪	rukk
룫	ruks
룬	run
룭	runj
룮	runh
룯	rut
룰	rul
룱	rulk
룲	rulm
룳	rulp
룴	ruls
룵	rult
룶	rulp
룷	rulh
룸	rum
룹	rup
룺	rups
룻	rus
룼	russ
룽	rung
룾	ruj
룿	ruch
뤀	ruk
뤁	rut
뤂	rup
뤃	ruh
뤄	rwo
뤅	rwok
뤆	rwokk
뤇	rwoks
뤈	rwon
뤉	rwonj
뤊	rwonh
뤋	rwot
뤌	rwol
뤍	rwolk
뤎	rwolm
뤏	rwolp
뤐	rwols
뤑	rwolt
뤒	rwolp
뤓	rwolh
뤔	rwom
뤕	rwop
뤖	rwops
뤗	rwos
뤘	rwoss
뤙	rwong
뤚	rwoj
뤛	rwoch
뤜	rwok
뤝	rwot
뤞	rwop
뤟	rwoh
뤠	rwe
뤡	rwek
뤢	rwekk
뤣	rweks
뤤	rwen
뤥	rwenj
뤦	rwenh
뤧	rwet
뤨	rwel
뤩	rwelk
뤪	rwelm
뤫	rwelp
뤬	rwels
뤭	rwelt
뤮	rwelp
뤯	rwelh
뤰	rwem
뤱	rwep
뤲	rweps
뤳	rwes
뤴	rwess
뤵	rweng
뤶	rwej
뤷	rwech
뤸	rwek
뤹	rwet
뤺	rwep
뤻	rweh
뤼	rwi
뤽	rwik
뤾	rwikk
뤿	rwiks
륀	rwin
륁	rwinj
륂	rwinh
륃	rwit
륄	rwil
륅	rwilk
륆	rwilm
륇	rwilp
륈	rwils
륉	rwilt
륊	rwilp
륋	rwilh
륌	rwim
륍	rwip
륎	rwips
륏	rwis
륐	rwiss
륑	rwing
륒	rwij
륓	rwich
륔	rwik
륕	rwit
륖	rwip
륗	rwih
류	ryu
륙	ryuk
륚	ryukk
륛	ryuks
륜	ryun
륝	ryunj
륞	ryunh
륟	ryut
률	ryul
륡	ryulk
륢	ryulm
륣	ryulp
륤	ryuls
륥	ryult
륦	ryulp
륧	ryulh
륨	ryum
륩	ryup
륪	ryups
륫	ryus
륬	ryuss
륭	ryung
륮	ryuj
륯	ryuch
륰	ryuk
륱	ryut
륲	ryup
륳	ryuh
르	reu
륵	reuk
륶	reukk
륷	reuks
른	reun
륹	reunj
륺	reunh
륻	reut
를	reul
륽	reulk
륾	reulm
륿	reulp
릀	reuls
릁	reult
릂	reulp
릃	reulh
름	reum
릅	reup
릆	reups
릇	reus
릈	reuss
릉	reung
릊	reuj
릋	reuch
릌	reuk
릍	reut
릎	reup
릏	reuh
릐	rui
릑	ruik
릒	ruikk
릓	ruiks
릔	ruin
릕	ruinj
릖	ruinh
릗	ruit
릘	ruil
릙	ruilk
릚	ruilm
릛	ruilp
릜	ruils
릝	ruilt
릞	ruilp
릟	ruilh
릠	ruim
릡	ruip
릢	ruips
릣	ruis
릤	ruiss
릥	ruing
릦	ruij
릧	ruich
릨	ruik
릩	ruit
릪	ruip
릫	ruih
리	ri
릭	rik
릮	rikk
릯	riks
린	rin
릱	rinj
릲	rinh
릳	rit
릴	ril
릵	rilk
릶	rilm
릷	rilp
릸	rils
릹	rilt
릺	rilp
릻	rilh
림	rim
립	rip
릾	rips
릿	ris
맀	riss
링	ring
맂	rij
맃	rich
맄	rik
맅	rit
맆	rip
맇	rih
마	ma
막	mak
맊	makk
맋	maks
만	man
맍	manj
많	manh
맏	mat
말	mal
맑	malk
맒	malm
맓	malp
맔	mals
맕	malt
맖	malp
맗	malh
맘	mam
맙	map
맚	maps
맛	mas
맜	mass
망	mang
맞	maj
맟	mach
맠	mak
맡	mat
맢	map
맣	mah
매	mae
맥	maek
맦	maekk
맧	maeks
맨	maen
맩	maenj
맪	maenh
맫	maet
맬	mael
맭	maelk
맮	maelm
맯	maelp
맰	maels
맱	maelt
맲	maelp
맳	maelh
맴	maem
맵	maep
맶	maeps
맷	maes
맸	maess
맹	maeng
맺	maej
맻	maech
맼	maek
맽	maet
맾	maep
맿	maeh
먀	mya
먁	myak
먂	myakk
먃	myaks
먄	myan
먅	myanj
먆	myanh
먇	myat
먈	myal
먉	myalk
먊	myalm
먋	myalp
먌	myals
먍	myalt
먎	myalp
먏	myalh
먐	myam
먑	myap
먒	myaps
먓	myas
먔	myass
먕	myang
먖	myaj
먗	myach
먘	myak
먙	myat
먚	myap
먛	myah
먜	myae
먝	myaek
먞	myaekk
먟	myaeks
먠	myaen
먡	myaenj
먢	myaenh
먣	myaet
먤	myael
먥	myaelk
먦	myaelm
먧	myaelp
먨	myaels
먩	myaelt
먪	myaelp
먫	myaelh
먬	myaem
먭	myaep
먮	myaeps
먯	myaes
먰	myaess
먱	myaeng
먲	myaej
먳	myaech
먴	myaek
먵	myaet
먶	myaep
먷	myaeh
머	meo
먹	meok
먺	meokk
먻	meoks
먼	meon
먽	meonj
먾	meonh
먿	meot
멀	meol
멁	meolk
멂	meolm
멃	meolp
멄	meols
멅	meolt
멆	meolp
멇	meolh
멈	meom
멉	meop
멊	meops
멋	meos
멌	meoss
멍	meong
멎	meoj
멏	meoch
멐	meok
멑	meot
멒	meop
멓	meoh
메	me
멕	mek
멖	mekk
멗	meks
멘	men
멙	menj
멚	menh
멛	met
멜	mel
멝	melk
멞	melm
멟	melp
멠	mels
멡	melt
멢	melp
멣	melh
멤	mem
멥	mep
멦	meps
멧	mes
멨	mess
멩	meng
멪	mej
멫	mech
멬	mek
멭	met
멮	mep
멯	meh
며	myeo
멱	myeok
멲	myeokk
멳	myeoks
면	myeon
멵	myeonj
멶	myeonh
멷	myeot
멸	myeol
멹	myoelk
멺	myeolm
멻	myoelp
멼	myeols
멽	myoelt
멾	myoelp
멿	myeolh
몀	myeom
몁	myeop
몂	myeops
몃	myeos
몄	myeoss
명	myeong
몆	myeoj
몇	myeoch
몈	myeok
몉	myeot
몊	myeop
몋	myeoh
몌	mye
몍	myek
몎	myekk
몏	myeks
몐	myen
몑	myenj
몒	myenh
몓	myet
몔	myel
몕	myelk
몖	myelm
몗	myelp
몘	myels
몙	myelt
몚	myelp
몛	myelh
몜	myem
몝	myep
몞	myeps
몟	myes
몠	myess
몡	myeng
몢	myej
몣	myech
몤	myek
몥	myet
몦	myep
몧	myeh
모	mo
목	mok
몪	mokk
몫	moks
몬	mon
몭	monj
몮	monh
몯	mot
몰	mol
몱	molk
몲	molm
몳	molp
몴	mols
몵	molt
몶	molp
몷	molh
몸	mom
몹	mop
몺	mops
못	mos
몼	moss
몽	mong
몾	moj
몿	moch
뫀	mok
뫁	mot
뫂	mop
뫃	moh
뫄	mwa
뫅	mwak
뫆	mwakk
뫇	mwaks
뫈	mwan
뫉	mwanj
뫊	mwanh
뫋	mwat
뫌	mwal
뫍	mwalk
뫎	mwalm
뫏	mwalp
뫐	mwals
뫑	mwalt
뫒	mwalp
뫓	mwalh
뫔	mwam
뫕	mwap
뫖	mwaps
뫗	mwas
뫘	mwass
뫙	mwang
뫚	mwaj
뫛	mwach
뫜	mwak
뫝	mwat
뫞	mwap
뫟	mwah
뫠	mwae
뫡	mwaek
뫢	mwaekk
뫣	mwaeks
뫤	mwaen
뫥	mwaenj
뫦	mwaenh
뫧	mwaet
뫨	mwael
뫩	mwaelk
뫪	mwaelm
뫫	mwaelp
뫬	mwaels
뫭	mwaelt
뫮	mwaelp
뫯	mwaelh
뫰	mwaem
뫱	mwaep
뫲	mwaeps
뫳	mwaes
뫴	mwaess
뫵	mwaeng
뫶	mwaej
뫷	mwaech
뫸	mwaek
뫹	mwaet
뫺	mwaep
뫻	mwaeh
뫼	moe
뫽	moek
뫾	moekk
뫿	moeks
묀	moen
묁	moenj
묂	moenh
묃	moet
묄	moel
묅	moelk
묆	moelm
묇	moelp
묈	moels
묉	moelt
묊	moelp
묋	moelh
묌	moem
묍	moep
묎	moeps
묏	moes
묐	moess
묑	moeng
묒	moej
묓	moech
묔	moek
묕	moet
묖	moep
묗	moeh
묘	myo
묙	myok
묚	myokk
묛	myoks
묜	myon
묝	myonj
묞	myonh
묟	myot
묠	myol
묡	myolk
묢	myolm
묣	myolp
묤	myols
묥	myolt
묦	myolp
묧	myolh
묨	myom
묩	myop
묪	myops
묫	myos
묬	myoss
묭	myong
묮	myoj
묯	myoch
묰	myok
묱	myot
묲	myop
묳	myoh
무	mu
묵	muk
묶	mukk
묷	muks
문	mun
묹	munj
묺	munh
묻	mut
물	mul
묽	mulk
묾	mulm
묿	mulp
뭀	muls
뭁	mult
뭂	mulp
뭃	mulh
뭄	mum
뭅	mup
뭆	mups
뭇	mus
뭈	muss
뭉	mung
뭊	muj
뭋	much
뭌	muk
뭍	mut
뭎	mup
뭏	muh
뭐	mwo
뭑	mwok
뭒	mwokk
뭓	mwoks
뭔	mwon
뭕	mwonj
뭖	mwonh
뭗	mwot
뭘	mwol
뭙	mwolk
뭚	mwolm
뭛	mwolp
뭜	mwols
뭝	mwolt
뭞	mwolp
뭟	mwolh
뭠	mwom
뭡	mwop
뭢	mwops
뭣	mwos
뭤	mwoss
뭥	mwong
뭦	mwoj
뭧	mwoch
뭨	mwok
뭩	mwot
뭪	mwop
뭫	mwoh
뭬	mwe
뭭	mwek
뭮	mwekk
뭯	mweks
뭰	mwen
뭱	mwenj
뭲	mwenh
뭳	mwet
뭴	mwel
뭵	mwelk
뭶	mwelm
뭷	mwelp
뭸	mwels
뭹	mwelt
뭺	mwelp
뭻	mwelh
뭼	mwem
뭽	mwep
뭾	mweps
뭿	mwes
뮀	mwess
뮁	mweng
뮂	mwej
뮃	mwech
뮄	mwek
뮅	mwet
뮆	mwep
뮇	mweh
뮈	mwi
뮉	mwik
뮊	mwikk
뮋	mwiks
뮌	mwin
뮍	mwinj
뮎	mwinh
뮏	mwit
뮐	mwil
뮑	mwilk
뮒	mwilm
뮓	mwilp
뮔	mwils
뮕	mwilt
뮖	mwilp
뮗	mwilh
뮘	mwim
뮙	mwip
뮚	mwips
뮛	mwis
뮜	mwiss
뮝	mwing
뮞	mwij
뮟	mwich
뮠	mwik
뮡	mwit
뮢	mwip
뮣	mwih
뮤	myu
뮥	myuk
뮦	myukk
뮧	myuks
뮨	myun
뮩	myunj
뮪	myunh
뮫	myut
뮬	myul
뮭	myulk
뮮	myulm
뮯	myulp
뮰	myuls
뮱	myult
뮲	myulp
뮳	myulh
뮴	myum
뮵	myup
뮶	myups
뮷	myus
뮸	myuss
뮹	myung
뮺	myuj
뮻	myuch
뮼	myuk
뮽	myut
뮾	myup
뮿	myuh
므	meu
믁	meuk
믂	meukk
믃	meuks
믄	meun
믅	meunj
믆	meunh
믇	meut
믈	meul
믉	meulk
믊	meulm
믋	meulp
믌	meuls
믍	meult
믎	meulp
믏	meulh
믐	meum
믑	meup
믒	meups
믓	meus
믔	meuss
믕	meung
믖	meuj
믗	meuch
믘	meuk
믙	meut
믚	meup
믛	meuh
믜	mui
믝	muik
믞	muikk
믟	muiks
믠	muin
믡	muinj
믢	muinh
믣	muit
믤	muil
믥	muilk
믦	muilm
믧	muilp
믨	muils
믩	muilt
믪	muilp
믫	muilh
믬	muim
믭	muip
믮	muips
믯	muis
믰	muiss
믱	muing
믲	muij
믳	muich
믴	muik
믵	muit
믶	muip
믷	muih
미	mi
믹	mik
믺	mikk
믻	miks
민	min
믽	minj
믾	minh
믿	mit
밀	mil
밁	milk
밂	milm
밃	milp
밄	mils
밅	milt
밆	milp
밇	milh
밈	mim
밉	mip
밊	mips
밋	mis
밌	miss
밍	ming
밎	mij
및	mich
밐	mik
밑	mit
밒	mip
밓	mih
바	ba
박	bak
밖	bakk
밗	baks
반	ban
밙	banj
밚	banh
받	bat
발	bal
밝	balk
밞	balm
밟	balp
밠	bals
밡	balt
밢	balp
밣	balh
밤	bam
밥	bap
밦	baps
밧	bas
밨	bass
방	bang
밪	baj
밫	bach
밬	bak
밭	bat
밮	bap
밯	bah
배	bae
백	baek
밲	baekk
밳	baeks
밴	baen
밵	baenj
밶	baenh
밷	baet
밸	bael
밹	baelk
밺	baelm
밻	baelp
밼	baels
밽	baelt
밾	baelp
밿	baelh
뱀	baem
뱁	baep
뱂	baeps
뱃	baes
뱄	baess
뱅	baeng
뱆	baej
뱇	baech
뱈	baek
뱉	baet
뱊	baep
뱋	baeh
뱌	bya
뱍	byak
뱎	byakk
뱏	byaks
뱐	byan
뱑	byanj
뱒	byanh
뱓	byat
뱔	byal
뱕	byalk
뱖	byalm
뱗	byalp
뱘	byals
뱙	byalt
뱚	byalp
뱛	byalh
뱜	byam
뱝	byap
뱞	byaps
뱟	byas
뱠	byass
뱡	byang
뱢	byaj
뱣	byach
뱤	byak
뱥	byat
뱦	byap
뱧	byah
뱨	byae
뱩	byaek
뱪	byaekk
뱫	byaeks
뱬	byaen
뱭	byaenj
뱮	byaenh
뱯	byaet
뱰	byael
뱱	byaelk
뱲	byaelm
뱳	byaelp
뱴	byaels
뱵	byaelt
뱶	byaelp
뱷	byaelh
뱸	byaem
뱹	byaep
뱺	byaeps
뱻	byaes
뱼	byaess
뱽	byaeng
뱾	byaej
뱿	byaech
벀	byaek
벁	byaet
벂	byaep
벃	byaeh
버	beo
벅	beok
벆	beokk
벇	beoks
번	beon
벉	beonj
벊	beonh
벋	beot
벌	beol
벍	beolk
벎	beolm
벏	beolp
벐	beols
벑	beolt
벒	beolp
벓	beolh
범	beom
법	beop
벖	beops
벗	beos
벘	beoss
벙	beong
벚	beoj
벛	beoch
벜	beok
벝	beot
벞	beop
벟	beoh
베	be
벡	bek
벢	bekk
벣	beks
벤	ben
벥	benj
벦	benh
벧	bet
벨	bel
벩	belk
벪	belm
벫	belp
벬	bels
벭	belt
벮	belp
벯	belh
벰	bem
벱	bep
벲	beps
벳	bes
벴	bess
벵	beng
벶	bej
벷	bech
벸	bek
벹	bet
벺	bep
벻	beh
벼	byeo
벽	byeok
벾	byeokk
벿	byeoks
변	byeon
볁	byeonj
볂	byeonh
볃	byeot
별	byeol
볅	byeolk
볆	byeolm
볇	byeolp
볈	byeols
볉	byeolt
볊	byeolp
볋	byeolh
볌	byeom
볍	byeop
볎	byeops
볏	byeos
볐	byeoss
병	byeong
볒	byeoj
볓	byeoch
볔	byeok
볕	byeot
볖	byeop
볗	byeoh
볘	bye
볙	byek
볚	byekk
볛	byeks
볜	byen
볝	byenj
볞	byenh
볟	byet
볠	byel
볡	byelk
볢	byelm
볣	byelp
볤	byels
볥	byelt
볦	byelp
볧	byelh
볨	byem
볩	byep
볪	byeps
볫	byes
볬	byess
볭	byeng
볮	byej
볯	byech
볰	byek
볱	byet
볲	byep
볳	byeh
보	bo
복	bok
볶	bokk
볷	boks
본	bon
볹	bonj
볺	bonh
볻	bot
볼	bol
볽	bolk
볾	bolm
볿	bolp
봀	bols
봁	bolt
봂	bolp
봃	bolh
봄	bom
봅	bop
봆	bops
봇	bos
봈	boss
봉	bong
봊	boj
봋	boch
봌	bok
봍	bot
봎	bop
봏	boh
봐	bwa
봑	bwak
봒	bwakk
봓	bwaks
봔	bwan
봕	bwanj
봖	bwanh
봗	bwat
봘	bwal
봙	bwalk
봚	bwalm
봛	bwalp
봜	bwals
봝	bwalt
봞	bwalp
봟	bwalh
봠	bwam
봡	bwap
봢	bwaps
봣	bwas
봤	bwass
봥	bwang
봦	bwaj
봧	bwach
봨	bwak
봩	bwat
봪	bwap
봫	bwah
봬	bwae
봭	bwaek
봮	bwaekk
봯	bwaeks
봰	bwaen
봱	bwaenj
봲	bwaenh
봳	bwaet
봴	bwael
봵	bwaelk
봶	bwaelm
봷	bwaelp
봸	bwaels
봹	bwaelt
봺	bwaelp
봻	bwaelh
봼	bwaem
봽	bwaep
봾	bwaeps
봿	bwaes
뵀	bwaess
뵁	bwaeng
뵂	bwaej
뵃	bwaech
뵄	bwaek
뵅	bwaet
뵆	bwaep
뵇	bwaeh
뵈	boe
뵉	boek
뵊	boekk
뵋	boeks
뵌	boen
뵍	boenj
뵎	boenh
뵏	boet
뵐	boel
뵑	boelk
뵒	boelm
뵓	boelp
뵔	boels
뵕	boelt
뵖	boelp
뵗	boelh
뵘	boem
뵙	boep
뵚	boeps
뵛	boes
뵜	boess
뵝	boeng
뵞	boej
뵟	boech
뵠	boek
뵡	boet
뵢	boep
뵣	boeh
뵤	byo
뵥	byok
뵦	byokk
뵧	byoks
뵨	byon
뵩	byonj
뵪	byonh
뵫	byot
뵬	byol
뵭	byolk
뵮	byolm
뵯	byolp
뵰	byols
뵱	byolt
뵲	byolp
뵳	byolh
뵴	byom
뵵	byop
뵶	byops
뵷	byos
뵸	byoss
뵹	byong
뵺	byoj
뵻	byoch
뵼	byok
뵽	byot
뵾	byop
뵿	byoh
부	bu
북	buk
붂	bukk
붃	buks
분	bun
붅	bunj
붆	bunh
붇	but
불	bul
붉	bulk
붊	bulm
붋	bulp
붌	buls
붍	bult
붎	bulp
붏	bulh
붐	bum
붑	bup
붒	bups
붓	bus
붔	buss
붕	bung
붖	buj
붗	buch
붘	buk
붙	but
붚	bup
붛	buh
붜	bwo
붝	bwok
붞	bwokk
붟	bwoks
붠	bwon
붡	bwonj
붢	bwonh
붣	bwot
붤	bwol
붥	bwolk
붦	bwolm
붧	bwolp
붨	bwols
붩	bwolt
붪	bwolp
붫	bwolh
붬	bwom
붭	bwop
붮	bwops
붯	bwos
붰	bwoss
붱	bwong
붲	bwoj
붳	bwoch
붴	bwok
붵	bwot
붶	bwop
붷	bwoh
붸	bwe
붹	bwek
붺	bwekk
붻	bweks
붼	bwen
붽	bwenj
붾	bwenh
붿	bwet
뷀	bwel
뷁	bwelk
뷂	bwelm
뷃	bwelp
뷄	bwels
뷅	bwelt
뷆	bwelp
뷇	bwelh
뷈	bwem
뷉	bwep
뷊	bweps
뷋	bwes
뷌	bwess
뷍	bweng
뷎	bwej
뷏	bwech
뷐	bwek
뷑	bwet
뷒	bwep
뷓	bweh
뷔	bwi
뷕	bwik
뷖	bwikk
뷗	bwiks
뷘	bwin
뷙	bwinj
뷚	bwinh
뷛	bwit
뷜	bwil
뷝	bwilk
뷞	bwilm
뷟	bwilp
뷠	bwils
뷡	bwilt
뷢	bwilp
뷣	bwilh
뷤	bwim
뷥	bwip
뷦	bwips
뷧	bwis
뷨	bwiss
뷩	bwing
뷪	bwij
뷫	bwich
뷬	bwik
뷭	bwit
뷮	bwip
뷯	bwih
뷰	byu
뷱	byuk
뷲	byukk
뷳	byuks
뷴	byun
뷵	byunj
뷶	byunh
뷷	byut
뷸	byul
뷹	byulk
뷺	byulm
뷻	byulp
뷼	byuls
뷽	byult
뷾	byulp
뷿	byulh
븀	byum
븁	byup
븂	byups
븃	byus
븄	byuss
븅	byung
븆	byuj
븇	byuch
븈	byuk
븉	byut
븊	byup
븋	byuh
브	beu
븍	beuk
븎	beukk
븏	beuks
븐	beun
븑	beunj
븒	beunh
븓	beut
블	beul
븕	beulk
븖	beulm
븗	beulp
븘	beuls
븙	beult
븚	beulp
븛	beulh
븜	beum
븝	beup
븞	beups
븟	beus
븠	beuss
븡	beung
븢	beuj
븣	beuch
븤	beuk
븥	beut
븦	beup
븧	beuh
븨	bui
븩	buik
븪	buikk
븫	buiks
븬	buin
븭	buinj
븮	buinh
븯	buit
븰	buil
븱	builk
븲	builm
븳	builp
븴	buils
븵	built
븶	builp
븷	builh
븸	buim
븹	buip
븺	buips
븻	buis
븼	buiss
븽	buing
븾	buij
븿	buich
빀	buik
빁	buit
빂	buip
빃	buih
비	bi
빅	bik
빆	bikk
빇	biks
빈	bin
빉	binj
빊	binh
빋	bit
빌	bil
빍	bilk
빎	bilm
빏	bilp
빐	bils
빑	bilt
빒	bilp
빓	bilh
빔	bim
빕	bip
빖	bips
빗	bis
빘	biss
빙	bing
빚	bij
빛	bich
빜	bik
빝	bit
빞	bip
빟	bih
빠	ppa
빡	ppak
빢	ppakk
빣	ppaks
빤	ppan
빥	ppanj
빦	ppanh
빧	ppat
빨	ppal
빩	ppalk
빪	ppalm
빫	ppalp
빬	ppals
빭	ppalt
빮	ppalp
빯	ppalh
빰	ppam
빱	ppap
빲	ppaps
빳	ppas
빴	ppass
빵	ppang
빶	ppaj
빷	ppach
빸	ppak
빹	ppat
빺	ppap
빻	ppah
빼	ppae
빽	ppaek
빾	ppaekk
빿	ppaeks
뺀	ppaen
뺁	ppaenj
뺂	ppaenh
뺃	ppaet
뺄	ppael
뺅	ppaelk
뺆	ppaelm
뺇	ppaelp
뺈	ppaels
뺉	ppaelt
뺊	ppaelp
뺋	ppaelh
뺌	ppaem
뺍	ppaep
뺎	ppaeps
뺏	ppaes
뺐	ppaess
뺑	ppaeng
뺒	ppaej
뺓	ppaech
뺔	ppaek
뺕	ppaet
뺖	ppaep
뺗	ppaeh
뺘	ppya
뺙	ppyak
뺚	ppyakk
뺛	ppyaks
뺜	ppyan
뺝	ppyanj
뺞	ppyanh
뺟	ppyat
뺠	ppyal
뺡	ppyalk
뺢	ppyalm
뺣	ppyalp
뺤	ppyals
뺥	ppyalt
뺦	ppyalp
뺧	ppyalh
뺨	ppyam
뺩	ppyap
뺪	ppyaps
뺫	ppyas
뺬	ppyass
뺭	ppyang
뺮	ppyaj
뺯	ppyach
뺰	ppyak
뺱	ppyat
뺲	ppyap
뺳	ppyah
뺴	ppyae
뺵	ppyaek
뺶	ppyaekk
뺷	ppyaeks
뺸	ppyaen
뺹	ppyaenj
뺺	ppyaenh
뺻	ppyaet
뺼	ppyael
뺽	ppyaelk
뺾	ppyaelm
뺿	ppyaelp
뻀	ppyaels
뻁	ppyaelt
뻂	ppyaelp
뻃	ppyaelh
뻄	ppyaem
뻅	ppyaep
뻆	ppyaeps
뻇	ppyaes
뻈	ppyaess
뻉	ppyaeng
뻊	ppyaej
뻋	ppyaech
뻌	ppyaek
뻍	ppyaet
뻎	ppyaep
뻏	ppyaeh
뻐	ppeo
뻑	ppeok
뻒	ppeokk
뻓	ppeoks
뻔	ppeon
뻕	ppeonj
뻖	ppeonh
뻗	ppeot
뻘	ppeol
뻙	ppeolk
뻚	ppeolm
뻛	ppeolp
뻜	ppeols
뻝	ppeolt
뻞	ppeolp
뻟	ppeolh
뻠	ppeom
뻡	ppeop
뻢	ppeops
뻣	ppeos
뻤	ppeoss
뻥	ppeong
뻦	ppeoj
뻧	ppeoch
뻨	ppeok
뻩	ppeot
뻪	ppeop
뻫	ppeoh
뻬	ppe
뻭	ppek
뻮	ppekk
뻯	ppeks
뻰	ppen
뻱	ppenj
뻲	ppenh
뻳	ppet
뻴	ppel
뻵	ppelk
뻶	ppelm
뻷	ppelp
뻸	ppels
뻹	ppelt
뻺	ppelp
뻻	ppelh
뻼	ppem
뻽	ppep
뻾	ppeps
뻿	ppes
뼀	ppess
뼁	ppeng
뼂	ppej
뼃	ppech
뼄	ppek
뼅	ppet
뼆	ppep
뼇	ppeh
뼈	ppyeo
뼉	ppyeok
뼊	ppyeokk
뼋	ppyeoks
뼌	ppyeon
뼍	ppyeonj
뼎	ppyeonh
뼏	ppyeot
뼐	ppyoel
뼑	ppyeolk
뼒	ppyeolm
뼓	ppyeolp
뼔	ppyeols
뼕	ppyeolt
뼖	ppyeolp
뼗	ppyeolh
뼘	ppyeom
뼙	ppyeop
뼚	ppyeops
뼛	ppyeos
뼜	ppyeoss
뼝	ppyeong
뼞	ppyeoj
뼟	ppyeoch
뼠	ppyeok
뼡	ppyeot
뼢	ppyoep
뼣	ppyeoh
뼤	ppye
뼥	ppyek
뼦	ppyekk
뼧	ppyeks
뼨	ppyen
뼩	ppyenj
뼪	ppyenh
뼫	ppyet
뼬	ppyel
뼭	ppyelk
뼮	ppyelm
뼯	ppyelp
뼰	ppyels
뼱	ppyelt
뼲	ppyelp
뼳	ppyelh
뼴	ppyem
뼵	ppyep
뼶	ppyeps
뼷	ppyes
뼸	ppyess
뼹	ppyeng
뼺	ppyej
뼻	ppyech
뼼	ppyek
뼽	ppyet
뼾	ppyep
뼿	ppyeh
뽀	ppo
뽁	ppok
뽂	ppokk
뽃	ppoks
뽄	ppon
뽅	pponj
뽆	pponh
뽇	ppot
뽈	ppol
뽉	ppolk
뽊	ppolm
뽋	ppolp
뽌	ppols
뽍	ppolt
뽎	ppolp
뽏	ppolh
뽐	ppom
뽑	ppop
뽒	ppops
뽓	ppos
뽔	pposs
뽕	ppong
뽖	ppoj
뽗	ppoch
뽘	ppok
뽙	ppot
뽚	ppop
뽛	ppoh
뽜	ppwa
뽝	ppwak
뽞	ppwakk
뽟	ppwaks
뽠	ppwan
뽡	ppwanj
뽢	ppwanh
뽣	ppwat
뽤	ppwal
뽥	ppwalk
뽦	ppwalm
뽧	ppwalp
뽨	ppwals
뽩	ppwalt
뽪	ppwalp
뽫	ppwalh
뽬	ppwam
뽭	ppwap
뽮	ppwaps
뽯	ppwas
뽰	ppwass
뽱	ppwang
뽲	ppwaj
뽳	ppwach
뽴	ppwak
뽵	ppwat
뽶	ppwap
뽷	ppwah
뽸	ppwae
뽹	ppwaek
뽺	ppwaekk
뽻	ppwaeks
뽼	ppwaen
뽽	ppwaenj
뽾	ppwaenh
뽿	ppwaet
뾀	ppwael
뾁	ppwaelk
뾂	ppwaelm
뾃	ppwaelp
뾄	ppwaels
뾅	ppwaelt
뾆	ppwaelp
뾇	ppwaelh
뾈	ppwaem
뾉	ppwaep
뾊	ppwaeps
뾋	ppwaes
뾌	ppwaess
뾍	ppwaeng
뾎	ppwaej
뾏	ppwaech
뾐	ppwaek
뾑	ppwaet
뾒	ppwaep
뾓	ppwaeh
뾔	ppoe
뾕	ppoek
뾖	ppoekk
뾗	ppoeks
뾘	ppoen
뾙	ppoenj
뾚	ppoenh
뾛	ppoet
뾜	ppoel
뾝	ppoelk
뾞	ppoelm
뾟	ppoelp
뾠	ppoels
뾡	ppoelt
뾢	ppoelp
뾣	ppoelh
뾤	ppoem
뾥	ppoep
뾦	ppoeps
뾧	ppoes
뾨	ppoess
뾩	ppoeng
뾪	ppoej
뾫	ppoech
뾬	ppoek
뾭	ppoet
뾮	ppoep
뾯	ppoeh
뾰	ppyo
뾱	ppyok
뾲	ppyokk
뾳	ppyoks
뾴	ppyon
뾵	ppyonj
뾶	ppyonh
뾷	ppyot
뾸	ppyol
뾹	ppyolk
뾺	ppyolm
뾻	ppyolp
뾼	ppyols
뾽	ppyolt
뾾	ppyolp
뾿	ppyolh
뿀	ppyom
뿁	ppyop
뿂	ppyops
뿃	ppyos
뿄	ppyoss
뿅	ppyong
뿆	ppyoj
뿇	ppyoch
뿈	ppyok
뿉	ppyot
뿊	ppoyp
뿋	ppyoh
뿌	ppu
뿍	ppuk
뿎	ppukk
뿏	ppuks
뿐	ppun
뿑	ppunj
뿒	ppunh
뿓	pput
뿔	ppul
뿕	ppulk
뿖	ppulm
뿗	ppulp
뿘	ppuls
뿙	ppult
뿚	ppulp
뿛	ppulh
뿜	ppum
뿝	ppup
뿞	ppups
뿟	ppus
뿠	ppuss
뿡	ppung
뿢	ppuj
뿣	ppuch
뿤	ppuk
뿥	pput
뿦	ppup
뿧	ppuh
뿨	ppwo
뿩	ppwok
뿪	ppwokk
뿫	ppwoks
뿬	ppwon
뿭	ppwonj
뿮	ppwonh
뿯	ppwot
뿰	ppwol
뿱	ppwolk
뿲	ppwolm
뿳	ppwolp
뿴	ppwols
뿵	ppwolt
뿶	ppwolp
뿷	ppwolh
뿸	ppwom
뿹	ppwop
뿺	ppwops
뿻	ppwos
뿼	ppwoss
뿽	ppwong
뿾	ppwoj
뿿	ppwoch
쀀	ppwok
쀁	ppwot
쀂	ppwop
쀃	ppwoh
쀄	ppwe
쀅	ppwek
쀆	ppwekk
쀇	ppweks
쀈	ppwen
쀉	ppwenj
쀊	ppwenh
쀋	ppwet
쀌	ppwel
쀍	ppwelk
쀎	ppwelm
쀏	ppwelp
쀐	ppwels
쀑	ppwelt
쀒	ppwelp
쀓	ppwelh
쀔	ppwem
쀕	ppwep
쀖	ppweps
쀗	ppwes
쀘	ppwess
쀙	ppweng
쀚	ppwej
쀛	ppwech
쀜	ppwek
쀝	ppwet
쀞	ppwep
쀟	ppweh
쀠	ppwi
쀡	ppwik
쀢	ppwikk
쀣	ppwiks
쀤	ppwin
쀥	ppwinj
쀦	ppwinh
쀧	ppwit
쀨	ppwil
쀩	ppwilk
쀪	ppwilm
쀫	ppwilp
쀬	ppwils
쀭	ppwilt
쀮	ppwilp
쀯	ppwilh
쀰	ppwim
쀱	ppwip
쀲	ppwips
쀳	ppwis
쀴	ppwiss
쀵	ppwing
쀶	ppwij
쀷	ppwich
쀸	ppwik
쀹	ppwit
쀺	ppwip
쀻	ppwih
쀼	ppyu
쀽	ppyuk
쀾	ppyukk
쀿	ppyuks
쁀	ppyun
쁁	ppyunj
쁂	ppyunh
쁃	ppyut
쁄	ppyul
쁅	ppyulk
쁆	ppyulm
쁇	ppyulp
쁈	ppyuls
쁉	ppyult
쁊	ppyulp
쁋	ppyulh
쁌	ppyum
쁍	ppyup
쁎	ppyups
쁏	ppyus
쁐	ppyuss
쁑	ppyung
쁒	ppyuj
쁓	ppyuch
쁔	ppyuk
쁕	ppyut
쁖	ppyup
쁗	ppyuh
쁘	ppeu
쁙	ppeuk
쁚	ppeukk
쁛	ppeuks
쁜	ppeun
쁝	ppeunj
쁞	ppeunh
쁟	ppeut
쁠	ppeul
쁡	ppeulk
쁢	ppeulm
쁣	ppeulp
쁤	ppeuls
쁥	ppeult
쁦	ppeulp
쁧	ppeulh
쁨	ppeum
쁩	ppeup
쁪	ppeups
쁫	ppeus
쁬	ppeuss
쁭	ppeung
쁮	ppeuj
쁯	ppeuch
쁰	ppeuk
쁱	ppeut
쁲	ppeup
쁳	ppeuh
쁴	ppui
쁵	ppuik
쁶	ppuikk
쁷	ppuiks
쁸	ppuin
쁹	ppuinj
쁺	ppuinh
쁻	ppuit
쁼	ppuil
쁽	ppuilk
쁾	ppuilm
쁿	ppuilp
삀	ppuils
삁	ppuilt
삂	ppuilp
삃	ppuilh
삄	ppuim
삅	ppuip
삆	ppuips
삇	ppuis
삈	ppuiss
삉	ppuing
삊	ppuij
삋	ppuich
삌	ppuik
삍	ppuit
삎	ppuip
삏	ppuih
삐	ppi
삑	ppik
삒	ppikk
삓	ppiks
삔	ppin
삕	ppinj
삖	ppinh
삗	ppit
삘	ppil
삙	ppilk
삚	ppilm
삛	ppilp
삜	ppils
삝	ppilt
삞	ppilp
삟	ppilh
삠	ppim
삡	ppip
삢	ppips
삣	ppis
삤	ppiss
삥	pping
삦	ppij
삧	ppich
삨	ppik
삩	ppit
삪	ppip
삫	ppih
사	sa
삭	sak
삮	sakk
삯	saks
산	san
삱	sanj
삲	sanh
삳	sat
살	sal
삵	salk
삶	salm
삷	salp
삸	sals
삹	salt
삺	salp
삻	salh
삼	sam
삽	sap
삾	saps
삿	sas
샀	sass
상	sang
샂	saj
샃	sach
샄	sak
샅	sat
샆	sap
샇	sah
새	sae
색	saek
샊	saekk
샋	saeks
샌	saen
샍	saenj
샎	saenh
샏	saet
샐	sael
샑	saelk
샒	saelm
샓	saelp
샔	saels
샕	saelt
샖	saelp
샗	saelh
샘	saem
샙	saep
샚	saeps
샛	saes
샜	saess
생	saeng
샞	saej
샟	saech
샠	saek
샡	saet
샢	saep
샣	saeh
샤	sya
샥	syak
샦	syakk
샧	syaks
샨	syan
샩	syanj
샪	syanh
샫	syat
샬	syal
샭	syalk
샮	syalm
샯	syalp
샰	syals
샱	syalt
샲	syalp
샳	syalh
샴	syam
샵	syap
샶	syaps
샷	syas
샸	syass
샹	syang
샺	syaj
샻	syach
샼	syak
샽	syat
샾	syap
샿	syah
섀	syae
섁	syaek
섂	syaekk
섃	syaeks
섄	syaen
섅	syaenj
섆	syaenh
섇	syaet
섈	syael
섉	syaelk
섊	syaelm
섋	syaelp
섌	syaels
섍	syaelt
섎	syaelp
섏	syaelh
섐	syaem
섑	syaep
섒	syaeps
섓	syaes
섔	syaess
섕	syaeng
섖	syaej
섗	syaech
섘	syaek
섙	syaet
섚	syaep
섛	syaeh
서	seo
석	seok
섞	seokk
섟	seoks
선	seon
섡	seonj
섢	seonh
섣	seot
설	seol
섥	seolk
섦	seolm
섧	seolp
섨	seols
섩	seolt
섪	seolp
섫	seolh
섬	seom
섭	seop
섮	seops
섯	seos
섰	seoss
성	seong
섲	seoj
섳	seoch
섴	seok
섵	seot
섶	seop
섷	seoh
세	se
섹	sek
섺	sekk
섻	seks
센	sen
섽	senj
섾	senh
섿	set
셀	sel
셁	selk
셂	selm
셃	selp
셄	sels
셅	selt
셆	selp
셇	selh
셈	sem
셉	sep
셊	seps
셋	ses
셌	sess
셍	seng
셎	sej
셏	sech
셐	sek
셑	set
셒	sep
셓	seh
셔	syeo
셕	syeok
셖	syeokk
셗	syeoks
션	syeon
셙	syeonj
셚	syeonh
셛	syeot
셜	syeol
셝	syeolk
셞	syeolm
셟	syeolp
셠	syeols
셡	syeolt
셢	syeolp
셣	syeolh
셤	syeom
셥	syeop
셦	syeops
셧	syeos
셨	syeoss
셩	syeong
셪	syeoj
셫	syeoch
셬	syeok
셭	syeot
셮	syeop
셯	syeoh
셰	sye
셱	syek
셲	syekk
셳	syeks
셴	syen
셵	syenj
셶	syenh
셷	syet
셸	syel
셹	syelk
셺	syelm
셻	syelp
셼	syels
셽	syelt
셾	syelp
셿	syelh
솀	syem
솁	syep
솂	syeps
솃	syes
솄	syess
솅	syeng
솆	syej
솇	syech
솈	syek
솉	syet
솊	syep
솋	syeh
소	so
속	sok
솎	sokk
솏	soks
손	son
솑	sonj
솒	sonh
솓	sot
솔	sol
솕	solk
솖	solm
솗	solp
솘	sols
솙	solt
솚	solp
솛	solh
솜	som
솝	sop
솞	sops
솟	sos
솠	soss
송	song
솢	soj
솣	soch
솤	sok
솥	sot
솦	sop
솧	soh
솨	swa
솩	swak
솪	swakk
솫	swaks
솬	swan
솭	swanj
솮	swanh
솯	swat
솰	swal
솱	swalk
솲	swalm
솳	swalp
솴	swals
솵	swalt
솶	swalp
솷	swalh
솸	swam
솹	swap
솺	swaps
솻	swas
솼	swass
솽	swang
솾	swaj
솿	swach
쇀	swak
쇁	swat
쇂	swap
쇃	swah
쇄	swae
쇅	swaek
쇆	swaekk
쇇	swaeks
쇈	swaen
쇉	swaenj
쇊	swaenh
쇋	swaet
쇌	swael
쇍	swaelk
쇎	swaelm
쇏	swaelp
쇐	swaels
쇑	swaelt
쇒	swaelp
쇓	swaelh
쇔	swaem
쇕	swaep
쇖	swaeps
쇗	swaes
쇘	swaess
쇙	swaeng
쇚	swaej
쇛	swaech
쇜	swaek
쇝	swaet
쇞	swaep
쇟	swaeh
쇠	soe
쇡	soek
쇢	soekk
쇣	soeks
쇤	soen
쇥	soenj
쇦	soenh
쇧	soet
쇨	soel
쇩	soelk
쇪	soelm
쇫	soelp
쇬	soels
쇭	soelt
쇮	soelp
쇯	soelh
쇰	soem
쇱	soep
쇲	soeps
쇳	soes
쇴	soess
쇵	soeng
쇶	soej
쇷	soech
쇸	soek
쇹	soet
쇺	soep
쇻	soeh
쇼	syo
쇽	syok
쇾	syokk
쇿	syoks
숀	syon
숁	syonj
숂	syonh
숃	syot
숄	syol
숅	syolk
숆	syolm
숇	syolp
숈	syols
숉	syolt
숊	syolp
숋	syolh
숌	syom
숍	syop
숎	syops
숏	syos
숐	syoss
숑	syong
숒	syoj
숓	syoch
숔	syok
숕	syot
숖	syop
숗	syoh
수	su
숙	suk
숚	sukk
숛	suks
순	sun
숝	sunj
숞	sunh
숟	sut
술	sul
숡	sulk
숢	sulm
숣	sulp
숤	suls
숥	sult
숦	sulp
숧	sulh
숨	sum
숩	sup
숪	sups
숫	sus
숬	suss
숭	sung
숮	suj
숯	such
숰	suk
숱	sut
숲	sup
숳	suh
숴	swo
숵	swok
숶	swokk
숷	swoks
숸	swon
숹	swonj
숺	swonh
숻	swot
숼	swol
숽	swolk
숾	swolm
숿	swolp
쉀	swols
쉁	swolt
쉂	swolp
쉃	swolh
쉄	swom
쉅	swop
쉆	swops
쉇	swos
쉈	swoss
쉉	swong
쉊	swoj
쉋	swoch
쉌	swok
쉍	swot
쉎	swop
쉏	swoh
쉐	swe
쉑	swek
쉒	swekk
쉓	sweks
쉔	swen
쉕	swenj
쉖	swenh
쉗	swet
쉘	swel
쉙	swelk
쉚	swelm
쉛	swelp
쉜	swels
쉝	swelt
쉞	swelp
쉟	swelh
쉠	swem
쉡	swep
쉢	sweps
쉣	swes
쉤	swess
쉥	sweng
쉦	swej
쉧	swech
쉨	swek
쉩	swet
쉪	swep
쉫	sweh
쉬	swi
쉭	swik
쉮	swikk
쉯	swiks
쉰	swin
쉱	swinj
쉲	swinh
쉳	swit
쉴	swil
쉵	swilk
쉶	swilm
쉷	swilp
쉸	swils
쉹	swilt
쉺	swilp
쉻	swilh
쉼	swim
쉽	swip
쉾	swips
쉿	swis
슀	swiss
슁	swing
슂	swij
슃	swich
슄	swik
슅	swit
슆	swip
슇	swih
슈	syu
슉	syuk
슊	syukk
슋	syuks
슌	syun
슍	syunj
슎	syunh
슏	syut
슐	syul
슑	syulk
슒	syulm
슓	syulp
슔	syuls
슕	syult
슖	syulp
슗	syulh
슘	syum
슙	syup
슚	syups
슛	syus
슜	syuss
슝	syung
슞	syuj
슟	syuch
슠	syuk
슡	syut
슢	syup
슣	syuh
스	seu
슥	seuk
슦	seukk
슧	seuks
슨	seun
슩	seunj
슪	seunh
슫	seut
슬	seul
슭	seulk
슮	seulm
슯	seulp
슰	seuls
슱	seult
슲	seulp
슳	seulh
슴	seum
습	seup
슶	seups
슷	seus
슸	seuss
승	seung
슺	seuj
슻	seuch
슼	seuk
슽	seut
슾	seup
슿	seuh
싀	sui
싁	suik
싂	suikk
싃	suiks
싄	suin
싅	suinj
싆	suinh
싇	suit
싈	suil
싉	suilk
싊	suilm
싋	suilp
싌	suils
싍	suilt
싎	suilp
싏	suilh
싐	suim
싑	suip
싒	suips
싓	suis
싔	suiss
싕	suing
싖	suij
싗	suich
싘	suik
싙	suit
싚	suip
싛	suih
시	si
식	sik
싞	sikk
싟	siks
신	sin
싡	sinj
싢	sinh
싣	sit
실	sil
싥	silk
싦	silm
싧	silp
싨	sils
싩	silt
싪	silp
싫	silh
심	sim
십	sip
싮	sips
싯	sis
싰	siss
싱	sing
싲	sij
싳	sich
싴	sik
싵	sit
싶	sip
싷	sih
싸	ssa
싹	ssak
싺	ssakk
싻	ssaks
싼	ssan
싽	ssanj
싾	ssanh
싿	ssat
쌀	ssal
쌁	ssalk
쌂	ssalm
쌃	ssalp
쌄	ssals
쌅	ssalt
쌆	ssalp
쌇	ssalh
쌈	ssam
쌉	ssap
쌊	ssaps
쌋	ssas
쌌	ssass
쌍	ssang
쌎	ssaj
쌏	ssach
쌐	ssak
쌑	ssat
쌒	ssap
쌓	ssah
쌔	ssae
쌕	ssaek
쌖	ssaekk
쌗	ssaeks
쌘	ssaen
쌙	ssaenj
쌚	ssaenh
쌛	ssaet
쌜	ssael
쌝	ssaelk
쌞	ssaelm
쌟	ssaelp
쌠	ssaels
쌡	ssaelt
쌢	ssaelp
쌣	ssaelh
쌤	ssaem
쌥	ssaep
쌦	ssaeps
쌧	ssaes
쌨	ssaess
쌩	ssaeng
쌪	ssaej
쌫	ssaech
쌬	ssaek
쌭	ssaet
쌮	ssaep
쌯	ssaeh
쌰	ssya
쌱	ssyak
쌲	ssyakk
쌳	ssyaks
쌴	ssyan
쌵	ssyanj
쌶	ssyanh
쌷	ssyat
쌸	ssyal
쌹	ssyalk
쌺	ssyalm
쌻	ssyalp
쌼	ssyals
쌽	ssyalt
쌾	ssyalp
쌿	ssyalh
썀	ssyam
썁	ssyap
썂	ssyaps
썃	ssyas
썄	ssyass
썅	ssyang
썆	ssyaj
썇	ssyach
썈	ssyak
썉	ssyat
썊	ssyap
썋	ssyah
썌	ssyae
썍	ssyaek
썎	ssyaekk
썏	ssyaeks
썐	ssyaen
썑	ssyaenj
썒	ssyaenh
썓	ssyaet
썔	ssyael
썕	ssyaelk
썖	ssyaelm
썗	ssyaelp
썘	ssyaels
썙	ssyaelt
썚	ssyaelp
썛	ssyaelh
썜	ssyaem
썝	ssyaep
썞	ssyaeps
썟	ssyaes
썠	ssyaess
썡	ssyaeng
썢	ssyaej
썣	ssyaech
썤	ssyaek
썥	ssyaet
썦	ssyaep
썧	ssyaeh
써	sseo
썩	sseok
썪	sseokk
썫	sseoks
썬	sseon
썭	sseonj
썮	sseonh
썯	sseot
썰	sseol
썱	sseolk
썲	sseolm
썳	sseolp
썴	sseols
썵	sseolt
썶	sseolp
썷	sseolh
썸	sseom
썹	sseop
썺	sseops
썻	sseos
썼	sseoss
썽	sseong
썾	sseoj
썿	sseoch
쎀	sseok
쎁	sseot
쎂	sseop
쎃	sseoh
쎄	sse
쎅	ssek
쎆	ssekk
쎇	sseks
쎈	ssen
쎉	ssenj
쎊	ssenh
쎋	sset
쎌	ssel
쎍	sselk
쎎	sselm
쎏	sselp
쎐	ssels
쎑	sselt
쎒	sselp
쎓	sselh
쎔	ssem
쎕	ssep
쎖	sseps
쎗	sses
쎘	ssess
쎙	sseng
쎚	ssej
쎛	ssech
쎜	ssek
쎝	sset
쎞	ssep
쎟	sseh
쎠	ssyeo
쎡	ssyeok
쎢	ssyeokk
쎣	ssyeoks
쎤	ssyeon
쎥	ssyeonj
쎦	ssyeonh
쎧	ssyeot
쎨	ssyeol
쎩	ssyeolk
쎪	ssyeolm
쎫	ssyeolp
쎬	ssyeols
쎭	ssyeolt
쎮	ssyeolp
쎯	ssyeolh
쎰	ssyeom
쎱	ssyeop
쎲	ssyeops
쎳	ssyeos
쎴	ssyeoss
쎵	ssyeong
쎶	ssyeoj
쎷	ssyeoch
쎸	ssyeok
쎹	ssyeot
쎺	ssyeop
쎻	ssyeoh
쎼	ssye
쎽	ssyek
쎾	ssyekk
쎿	ssyeks
쏀	ssyen
쏁	ssyenj
쏂	ssyenh
쏃	ssyet
쏄	ssyel
쏅	ssyelk
쏆	ssyelm
쏇	ssyelp
쏈	ssyels
쏉	ssyelt
쏊	ssyelp
쏋	ssyelh
쏌	ssyem
쏍	ssyep
쏎	ssyeps
쏏	ssyes
쏐	ssyess
쏑	ssyeng
쏒	ssyej
쏓	ssyech
쏔	ssyek
쏕	ssyet
쏖	ssyep
쏗	ssyeh
쏘	sso
쏙	ssok
쏚	ssokk
쏛	ssoks
쏜	sson
쏝	ssonj
쏞	ssonh
쏟	ssot
쏠	ssol
쏡	ssolk
쏢	ssolm
쏣	ssolp
쏤	ssols
쏥	ssolt
쏦	ssolp
쏧	ssolh
쏨	ssom
쏩	ssop
쏪	ssops
쏫	ssos
쏬	ssoss
쏭	ssong
쏮	ssoj
쏯	ssoch
쏰	ssok
쏱	ssot
쏲	ssop
쏳	ssoh
쏴	sswa
쏵	sswak
쏶	sswakk
쏷	sswaks
쏸	sswan
쏹	sswanj
쏺	sswanh
쏻	sswat
쏼	sswal
쏽	sswalk
쏾	sswalm
쏿	sswalp
쐀	sswals
쐁	sswalt
쐂	sswalp
쐃	sswalh
쐄	sswam
쐅	sswap
쐆	sswaps
쐇	sswas
쐈	sswass
쐉	sswang
쐊	sswaj
쐋	sswach
쐌	sswak
쐍	sswat
쐎	sswap
쐏	sswah
쐐	sswae
쐑	sswaek
쐒	sswaekk
쐓	sswaeks
쐔	sswaen
쐕	sswaenj
쐖	sswaenh
쐗	sswaet
쐘	sswael
쐙	sswaelk
쐚	sswaelm
쐛	sswaelp
쐜	sswaels
쐝	sswaelt
쐞	sswaelp
쐟	sswaelh
쐠	sswaem
쐡	sswaep
쐢	sswaeps
쐣	sswaes
쐤	sswaess
쐥	sswaeng
쐦	sswaej
쐧	sswaech
쐨	sswaek
쐩	sswaet
쐪	sswaep
쐫	sswaeh
쐬	ssoe
쐭	ssoek
쐮	ssoekk
쐯	ssoeks
쐰	ssoen
쐱	ssoenj
쐲	ssoenh
쐳	ssoet
쐴	ssoel
쐵	ssoelk
쐶	ssoelm
쐷	ssoelp
쐸	ssoels
쐹	ssoelt
쐺	ssoelp
쐻	ssoelh
쐼	ssoem
쐽	ssoep
쐾	ssoeps
쐿	ssoes
쑀	ssoess
쑁	ssoeng
쑂	ssoej
쑃	ssoech
쑄	ssoek
쑅	ssoet
쑆	ssoep
쑇	ssoeh
쑈	ssyo
쑉	ssyok
쑊	ssyokk
쑋	ssyoks
쑌	ssyon
쑍	ssyonj
쑎	ssyonh
쑏	ssyot
쑐	ssyol
쑑	ssyolk
쑒	ssyolm
쑓	ssyolp
쑔	ssyols
쑕	ssyolt
쑖	ssyolp
쑗	ssyolh
쑘	ssyom
쑙	ssyop
쑚	ssyops
쑛	ssyos
쑜	ssyoss
쑝	ssyong
쑞	ssyoj
쑟	ssyoch
쑠	ssyok
쑡	ssyot
쑢	ssyop
쑣	ssyoh
쑤	ssu
쑥	ssuk
쑦	ssukk
쑧	ssuks
쑨	ssun
쑩	ssunj
쑪	ssunh
쑫	ssut
쑬	ssul
쑭	ssulk
쑮	ssulm
쑯	ssulp
쑰	ssuls
쑱	ssult
쑲	ssulp
쑳	ssulh
쑴	ssum
쑵	ssup
쑶	ssups
쑷	ssus
쑸	ssuss
쑹	ssung
쑺	ssuj
쑻	ssuch
쑼	ssuk
쑽	ssut
쑾	ssup
쑿	ssuh
쒀	sswo
쒁	sswok
쒂	sswokk
쒃	sswoks
쒄	sswon
쒅	sswonj
쒆	sswonh
쒇	sswot
쒈	sswol
쒉	sswolk
쒊	sswolm
쒋	sswolp
쒌	sswols
쒍	sswolt
쒎	sswolp
쒏	sswolh
쒐	sswom
쒑	sswop
쒒	sswops
쒓	sswos
쒔	sswoss
쒕	sswong
쒖	sswoj
쒗	sswoch
쒘	sswok
쒙	sswot
쒚	sswop
쒛	sswoh
쒜	sswe
쒝	sswek
쒞	sswekk
쒟	ssweks
쒠	sswen
쒡	sswenj
쒢	sswenh
쒣	sswet
쒤	sswel
쒥	sswelk
쒦	sswelm
쒧	sswelp
쒨	sswels
쒩	sswelt
쒪	sswelp
쒫	sswelh
쒬	sswem
쒭	sswep
쒮	ssweps
쒯	sswes
쒰	sswess
쒱	ssweng
쒲	sswej
쒳	sswech
쒴	sswek
쒵	sswet
쒶	sswep
쒷	ssweh
쒸	sswi
쒹	sswik
쒺	sswikk
쒻	sswiks
쒼	sswin
쒽	sswinj
쒾	sswinh
쒿	sswit
쓀	sswil
쓁	sswilk
쓂	sswilm
쓃	sswilp
쓄	sswils
쓅	sswilt
쓆	sswilp
쓇	sswilh
쓈	sswim
쓉	sswip
쓊	sswips
쓋	sswis
쓌	sswiss
쓍	sswing
쓎	sswij
쓏	sswich
쓐	sswik
쓑	sswit
쓒	sswip
쓓	sswih
쓔	ssyu
쓕	ssyuk
쓖	ssyukk
쓗	ssyuks
쓘	ssyun
쓙	ssyunj
쓚	ssyunh
쓛	ssyut
쓜	ssyul
쓝	ssyulk
쓞	ssyulm
쓟	ssyulp
쓠	ssyuls
쓡	ssyult
쓢	ssyulp
쓣	ssyulh
쓤	ssyum
쓥	ssyup
쓦	ssyups
쓧	ssyus
쓨	ssyuss
쓩	ssyung
쓪	ssyuj
쓫	ssyuch
쓬	ssyuk
쓭	ssyut
쓮	ssyup
쓯	ssyuh
쓰	sseu
쓱	sseuk
쓲	sseukk
쓳	sseuks
쓴	sseun
쓵	sseunj
쓶	sseunh
쓷	sseut
쓸	sseul
쓹	sseulk
쓺	sseulm
쓻	sseulp
쓼	sseuls
쓽	sseult
쓾	sseulp
쓿	sseulh
씀	sseum
씁	sseup
씂	sseups
씃	sseus
씄	sseuss
씅	sseung
씆	sseuj
씇	sseuch
씈	sseuk
씉	sseut
씊	sseup
씋	sseuh
씌	ssui
씍	ssuik
씎	ssuikk
씏	ssuiks
씐	ssuin
씑	ssuinj
씒	ssuinh
씓	ssuit
씔	ssuil
씕	ssuilk
씖	ssuilm
씗	ssuilp
씘	ssuils
씙	ssuilt
씚	ssuilp
씛	ssuilh
씜	ssuim
씝	ssuip
씞	ssuips
씟	ssuis
씠	ssuiss
씡	ssuing
씢	ssuij
씣	ssuich
씤	ssuik
씥	ssuit
씦	ssuip
씧	ssuih
씨	ssi
씩	ssik
씪	ssikk
씫	ssiks
씬	ssin
씭	ssinj
씮	ssinh
씯	ssit
씰	ssil
씱	ssilk
씲	ssilm
씳	ssilp
씴	ssils
씵	ssilt
씶	ssilp
씷	ssilh
씸	ssim
씹	ssip
씺	ssips
씻	ssis
씼	ssiss
씽	ssing
씾	ssij
씿	ssich
앀	ssik
앁	ssit
앂	ssip
앃	ssih
아	nga
악	ngak
앆	ngakk
앇	ngaks
안	ngan
앉	nganj
않	nganh
앋	ngat
알	ngal
앍	ngalk
앎	ngalm
앏	ngalp
앐	ngals
앑	ngalt
앒	ngalp
앓	ngalh
암	ngam
압	ngap
앖	ngaps
앗	ngas
았	ngass
앙	ngang
앚	ngaj
앛	ngach
앜	ngak
앝	ngat
앞	ngap
앟	ngah
애	ngae
액	ngaek
앢	ngaekk
앣	ngaeks
앤	ngaen
앥	ngaenj
앦	ngaenh
앧	ngaet
앨	ngael
앩	ngaelk
앪	ngaelm
앫	ngaelp
앬	ngaels
앭	ngaelt
앮	ngaelp
앯	ngaelh
앰	ngaem
앱	ngaep
앲	ngaeps
앳	ngaes
앴	ngaess
앵	ngaeng
앶	ngaej
앷	ngaech
앸	ngaek
앹	ngaet
앺	ngaep
앻	ngaeh
야	ngya
약	ngyak
앾	ngyakk
앿	ngyaks
얀	ngyan
얁	ngyanj
얂	ngyanh
얃	ngyat
얄	ngyal
얅	ngyalk
얆	ngyalm
얇	ngyalp
얈	ngyals
얉	ngyalt
얊	ngyalp
얋	ngyalh
얌	ngyam
얍	ngyap
얎	ngyaps
얏	ngyas
얐	ngyass
양	ngyang
얒	ngyaj
얓	ngyach
얔	ngyak
얕	ngyat
얖	ngyap
얗	ngyah
얘	ngyae
얙	ngyaek
얚	ngyaekk
얛	ngyaeks
얜	ngyaen
얝	ngyaenj
얞	ngyaenh
얟	ngyaet
얠	ngyael
얡	ngyaelk
얢	ngyaelm
얣	ngyaelp
얤	ngyaels
얥	ngyaelt
얦	ngyaelp
얧	ngyaelh
얨	ngyaem
얩	ngyaep
얪	ngyaeps
얫	ngyaes
얬	ngyaess
얭	ngyaeng
얮	ngyaej
얯	ngyaech
얰	ngyaek
얱	ngyaet
얲	ngyaep
얳	ngyaeh
어	ngeo
억	ngeok
얶	ngeokk
얷	ngeoks
언	ngeon
얹	ngeonj
얺	ngeonh
얻	ngeot
얼	ngeol
얽	ngeolk
얾	ngeolm
얿	ngeolp
엀	ngeols
엁	ngeolt
엂	ngeolp
엃	ngeolh
엄	ngeom
업	ngeop
없	ngeops
엇	ngeos
었	ngeoss
엉	ngeong
엊	ngeoj
엋	ngeoch
엌	ngeok
엍	ngeot
엎	ngeop
엏	ngeoh
에	nge
엑	ngek
엒	ngekk
엓	ngeks
엔	ngen
엕	ngenj
엖	ngenh
엗	nget
엘	ngel
엙	ngelk
엚	ngelm
엛	ngelp
엜	ngels
엝	ngelt
엞	ngelp
엟	ngelh
엠	ngem
엡	ngep
엢	ngeps
엣	nges
엤	ngess
엥	ngeng
엦	ngej
엧	ngech
엨	ngek
엩	nget
엪	ngep
엫	ngeh
여	ngyeo
역	ngyeok
엮	ngyeokk
엯	ngyeoks
연	ngyeon
엱	ngyeonj
엲	ngyeonh
엳	ngyeot
열	ngyeol
엵	ngyeolk
엶	ngyeolm
엷	ngyeolp
엸	ngyeols
엹	ngyeolt
엺	ngyeolp
엻	ngyeolh
염	ngyeom
엽	ngyeop
엾	ngyeops
엿	ngyeos
였	ngyeoss
영	ngyeong
옂	ngyeoj
옃	ngyeoch
옄	ngyeok
옅	ngyeot
옆	ngyeop
옇	ngyeoh
예	ngye
옉	ngyek
옊	ngyekk
옋	ngyeks
옌	ngyen
옍	ngyenj
옎	ngyenh
옏	ngyet
옐	ngyel
옑	ngyelk
옒	ngyelm
옓	ngyelp
옔	ngyels
옕	ngyelt
옖	ngyelp
옗	ngyelh
옘	ngyem
옙	ngyep
옚	ngyeps
옛	ngyes
옜	ngyess
옝	ngyeng
옞	ngyej
옟	ngyech
옠	ngyek
옡	ngyet
옢	ngyep
옣	ngyeh
오	ngo
옥	ngok
옦	ngokk
옧	ngoks
온	ngon
옩	ngonj
옪	ngonh
옫	ngot
올	ngol
옭	ngolk
옮	ngolm
옯	ngolp
옰	ngols
옱	ngolt
옲	ngolp
옳	ngolh
옴	ngom
옵	ngop
옶	ngops
옷	ngos
옸	ngoss
옹	ngong
옺	ngoj
옻	ngoch
옼	ngok
옽	ngot
옾	ngop
옿	ngoh
와	ngwa
왁	ngwak
왂	ngwakk
왃	ngwaks
완	ngwan
왅	ngwanj
왆	ngwanh
왇	ngwat
왈	ngwal
왉	ngwalk
왊	ngwalm
왋	ngwalp
왌	ngwals
왍	ngwalt
왎	ngwalp
왏	ngwalh
왐	ngwam
왑	ngwap
왒	ngwaps
왓	ngwas
왔	ngwass
왕	ngwang
왖	ngwaj
왗	ngwach
왘	ngwak
왙	ngwat
왚	ngwap
왛	ngwah
왜	ngwae
왝	ngwaek
왞	ngwaekk
왟	ngwaeks
왠	ngwaen
왡	ngwaenj
왢	ngwaenh
왣	ngwaet
왤	ngwael
왥	ngwaelk
왦	ngwaelm
왧	ngwaelp
왨	ngwaels
왩	ngwaelt
왪	ngwaelp
왫	ngwaelh
왬	ngwaem
왭	ngwaep
왮	ngwaeps
왯	ngwaes
왰	ngwaess
왱	ngwaeng
왲	ngwaej
왳	ngwaech
왴	ngwaek
왵	ngwaet
왶	ngwaep
왷	ngwaeh
외	ngoe
왹	ngoek
왺	ngoekk
왻	ngoeks
왼	ngoen
왽	ngoenj
왾	ngoenh
왿	ngoet
욀	ngoel
욁	ngoelk
욂	ngoelm
욃	ngoelp
욄	ngoels
욅	ngoelt
욆	ngoelp
욇	ngoelh
욈	ngoem
욉	ngoep
욊	ngoeps
욋	ngoes
욌	ngoess
욍	ngoeng
욎	ngoej
욏	ngoech
욐	ngoek
욑	ngoet
욒	ngoep
욓	ngoeh
요	ngyo
욕	ngyok
욖	ngyokk
욗	ngyoks
욘	ngyon
욙	ngyonj
욚	ngyonh
욛	ngyot
욜	ngyol
욝	ngyolk
욞	ngyolm
욟	ngyolp
욠	ngyols
욡	ngyolt
욢	ngyolp
욣	ngyolh
욤	ngyom
욥	ngyop
욦	ngyops
욧	ngyos
욨	ngyoss
용	ngyong
욪	ngyoj
욫	ngyoch
욬	ngyok
욭	ngyot
욮	ngyop
욯	ngyoh
우	ngu
욱	nguk
욲	ngukk
욳	nguks
운	ngun
욵	ngunj
욶	ngunh
욷	ngut
울	ngul
욹	ngulk
욺	ngulm
욻	ngulp
욼	nguls
욽	ngult
욾	ngulp
욿	ngulh
움	ngum
웁	ngup
웂	ngups
웃	ngus
웄	nguss
웅	ngung
웆	nguj
웇	nguch
웈	nguk
웉	ngut
웊	ngup
웋	nguh
워	ngwo
웍	ngwok
웎	ngwokk
웏	ngwoks
원	ngwon
웑	ngwonj
웒	ngwonh
웓	ngwot
월	ngwol
웕	ngwolk
웖	ngwolm
웗	ngwolp
웘	ngwols
웙	ngwolt
웚	ngwolp
웛	ngwolh
웜	ngwom
웝	ngwop
웞	ngwops
웟	ngwos
웠	ngwoss
웡	ngwong
웢	ngwoj
웣	ngwoch
웤	ngwok
웥	ngwot
웦	ngwop
웧	ngwoh
웨	ngwe
웩	ngwek
웪	ngwekk
웫	ngweks
웬	ngwen
웭	ngwenj
웮	ngwenh
웯	ngwet
웰	ngwel
웱	ngwelk
웲	ngwelm
웳	ngwelp
웴	ngwels
웵	ngwelt
웶	ngwelp
웷	ngwelh
웸	ngwem
웹	ngwep
웺	ngweps
웻	ngwes
웼	ngwess
웽	ngweng
웾	ngwej
웿	ngwech
윀	ngwek
윁	ngwet
윂	ngwep
윃	ngweh
위	ngwi
윅	ngwik
윆	ngwikk
윇	ngwiks
윈	ngwin
윉	ngwinj
윊	ngwinh
윋	ngwit
윌	ngwil
윍	ngwilk
윎	ngwilm
윏	ngwilp
윐	ngwils
윑	ngwilt
윒	ngwilp
윓	ngwilh
윔	ngwim
윕	ngwip
윖	ngwips
윗	ngwis
윘	ngwiss
윙	ngwing
윚	ngwij
윛	ngwich
윜	ngwik
윝	ngwit
윞	ngwip
윟	ngwih
유	ngyu
육	ngyuk
윢	ngyukk
윣	ngyuks
윤	ngyun
윥	ngyunj
윦	ngyunh
윧	ngyut
율	ngyul
윩	ngyulk
윪	ngyulm
윫	ngyulp
윬	ngyuls
윭	ngyult
윮	ngyulp
윯	ngyulh
윰	ngyum
윱	ngyup
윲	ngyups
윳	ngyus
윴	ngyuss
융	ngyung
윶	ngyuj
윷	ngyuch
윸	ngyuk
윹	ngyut
윺	ngyup
윻	ngyuh
으	ngeu
윽	ngeuk
윾	ngeukk
윿	ngeuks
은	ngeun
읁	ngeunj
읂	ngeunh
읃	ngeut
을	ngeul
읅	ngeulk
읆	ngeulm
읇	ngeulp
읈	ngeuls
읉	ngeult
읊	ngeulp
읋	ngeulh
음	ngeum
읍	ngeup
읎	ngeups
읏	ngeus
읐	ngeuss
응	ngeung
읒	ngeuj
읓	ngeuch
읔	ngeuk
읕	ngeut
읖	ngeup
읗	ngeuh
의	ngui
읙	nguik
읚	nguikk
읛	nguiks
읜	nguin
읝	nguinj
읞	nguinh
읟	nguit
읠	nguil
읡	nguilk
읢	nguilm
읣	nguilp
읤	nguils
읥	nguilt
읦	nguilp
읧	nguilh
읨	nguim
읩	nguip
읪	nguips
읫	nguis
읬	nguiss
읭	nguing
읮	nguij
읯	nguich
읰	nguik
읱	nguit
읲	nguip
읳	nguih
이	ngi
익	ngik
읶	ngikk
읷	ngiks
인	ngin
읹	nginj
읺	nginh
읻	ngit
일	ngil
읽	ngilk
읾	ngilm
읿	ngilp
잀	ngils
잁	ngilt
잂	ngilp
잃	ngilh
임	ngim
입	ngip
잆	ngips
잇	ngis
있	ngiss
잉	nging
잊	ngij
잋	ngich
잌	ngik
잍	ngit
잎	ngip
잏	ngih
자	ja
작	jak
잒	jakk
잓	jaks
잔	jan
잕	janj
잖	janh
잗	jat
잘	jal
잙	jalk
잚	jalm
잛	jalp
잜	jals
잝	jalt
잞	jalp
잟	jalh
잠	jam
잡	jap
잢	japs
잣	jas
잤	jass
장	jang
잦	jaj
잧	jach
잨	jak
잩	jat
잪	jap
잫	jah
재	jae
잭	jaek
잮	jaekk
잯	jaeks
잰	jaen
잱	jaenj
잲	jaenh
잳	jaet
잴	jael
잵	jaelk
잶	jaelm
잷	jaelp
잸	jaels
잹	jaelt
잺	jaelp
잻	jaelh
잼	jaem
잽	jaep
잾	jaeps
잿	jaes
쟀	jaess
쟁	jaeng
쟂	jaej
쟃	jaech
쟄	jaek
쟅	jaet
쟆	jaep
쟇	jaeh
쟈	jya
쟉	jyak
쟊	jyakk
쟋	jyaks
쟌	jyan
쟍	jyanj
쟎	jyanh
쟏	jyat
쟐	jyal
쟑	jyalk
쟒	jyalm
쟓	jyalp
쟔	jyals
쟕	jyalt
쟖	jyalp
쟗	jyalh
쟘	jyam
쟙	jyap
쟚	jyaps
쟛	jyas
쟜	jyass
쟝	jyang
쟞	jyaj
쟟	jyach
쟠	jyak
쟡	jyat
쟢	jyap
쟣	jyah
쟤	jyae
쟥	jyaek
쟦	jyaekk
쟧	jyaeks
쟨	jyaen
쟩	jyaenj
쟪	jyaenh
쟫	jyaet
쟬	jyael
쟭	jyaelk
쟮	jyaelm
쟯	jyaelp
쟰	jyaels
쟱	jyaelt
쟲	jyaelp
쟳	jyaelh
쟴	jyaem
쟵	jyaep
쟶	jyaeps
쟷	jyaes
쟸	jyaess
쟹	jyaeng
쟺	jyaej
쟻	jyaech
쟼	jyaek
쟽	jyaet
쟾	jyaep
쟿	jyaeh
저	jeo
적	jeok
젂	jeokk
젃	jeoks
전	jeon
젅	jeonj
젆	jeonh
젇	jeot
절	jeol
젉	jeolk
젊	jeolm
젋	jeolp
젌	jeols
젍	jeolt
젎	jeolp
젏	jeolh
점	jeom
접	jeop
젒	jeops
젓	jeos
젔	jeoss
정	jeong
젖	jeoj
젗	jeoch
젘	jeok
젙	jeot
젚	jeop
젛	jeoh
제	je
젝	jek
젞	jekk
젟	jeks
젠	jen
젡	jenj
젢	jenh
젣	jet
젤	jel
젥	jelk
젦	jelm
젧	jelp
젨	jels
젩	jelt
젪	jelp
젫	jelh
젬	jem
젭	jep
젮	jeps
젯	jes
젰	jess
젱	jeng
젲	jej
젳	jech
젴	jek
젵	jet
젶	jep
젷	jeh
져	jyeo
젹	jyeok
젺	jyeokk
젻	jyeoks
젼	jyeon
젽	jyeonj
젾	jyeonh
젿	jyeot
졀	jyeol
졁	jyeolk
졂	jyeolm
졃	jyeolp
졄	jyeols
졅	jyeolt
졆	jyeolp
졇	jyeolh
졈	jyeom
졉	jyeop
졊	jyeops
졋	jyeos
졌	jyeoss
졍	jyeong
졎	jyeoj
졏	jyeoch
졐	jyeok
졑	jyeot
졒	jyeop
졓	jyeoh
졔	jye
졕	jyek
졖	jyekk
졗	jyeks
졘	jyen
졙	jyenj
졚	jyenh
졛	jyet
졜	jyel
졝	jyelk
졞	jyelm
졟	jyelp
졠	jyels
졡	jyelt
졢	jyelp
졣	jyelh
졤	jyem
졥	jyep
졦	jyeps
졧	jyes
졨	jyess
졩	jyeng
졪	jyej
졫	jyech
졬	jyek
졭	jyet
졮	jyep
졯	jyeh
조	jo
족	jok
졲	jokk
졳	joks
존	jon
졵	jonj
졶	jonh
졷	jot
졸	jol
졹	jolk
졺	jolm
졻	jolp
졼	jols
졽	jolt
졾	jolp
졿	jolh
좀	jom
좁	jop
좂	jops
좃	jos
좄	joss
종	jong
좆	joj
좇	joch
좈	jok
좉	jot
좊	jop
좋	joh
좌	jwa
좍	jwak
좎	jwakk
좏	jwaks
좐	jwan
좑	jwanj
좒	jwanh
좓	jwat
좔	jwal
좕	jwalk
좖	jwalm
좗	jwalp
좘	jwals
좙	jwalt
좚	jwalp
좛	jwalh
좜	jwam
좝	jwap
좞	jwaps
좟	jwas
좠	jwass
좡	jwang
좢	jwaj
좣	jwach
좤	jwak
좥	jwat
좦	jwap
좧	jwah
좨	jwae
좩	jwaek
좪	jwaekk
좫	jwaeks
좬	jwaen
좭	jwaenj
좮	jwaenh
좯	jwaet
좰	jwael
좱	jwaelk
좲	jwaelm
좳	jwaelp
좴	jwaels
좵	jwaelt
좶	jwaelp
좷	jwaelh
좸	jwaem
좹	jwaep
좺	jwaeps
좻	jwaes
좼	jwaess
좽	jwaeng
좾	jwaej
좿	jwaech
죀	jwaek
죁	jwaet
죂	jwaep
죃	jwaeh
죄	joe
죅	joek
죆	joekk
죇	joeks
죈	joen
죉	joenj
죊	joenh
죋	joet
죌	joel
죍	joelk
죎	joelm
죏	joelp
죐	joels
죑	joelt
죒	joelp
죓	joelh
죔	joem
죕	joep
죖	joeps
죗	joes
죘	joess
죙	joeng
죚	joej
죛	joech
죜	joek
죝	joet
죞	joep
죟	joeh
죠	jyo
죡	jyok
죢	jyokk
죣	jyoks
죤	jyon
죥	jyonj
죦	jyonh
죧	jyot
죨	jyol
죩	jyolk
죪	jyolm
죫	jyolp
죬	jyols
죭	jyolt
죮	jyolp
죯	jyolh
죰	jyom
죱	jyop
죲	jyops
죳	jyos
죴	jyoss
죵	jyong
죶	jyoj
죷	jyoch
죸	jyok
죹	jyot
죺	jyop
죻	jyoh
주	ju
죽	juk
죾	jukk
죿	juks
준	jun
줁	junj
줂	junh
줃	jut
줄	jul
줅	julk
줆	julm
줇	julp
줈	juls
줉	jult
줊	julp
줋	julh
줌	jum
줍	jup
줎	jups
줏	jus
줐	juss
중	jung
줒	juj
줓	juch
줔	juk
줕	jut
줖	jup
줗	juh
줘	jwo
줙	jwok
줚	jwokk
줛	jwoks
줜	jwon
줝	jwonj
줞	jwonh
줟	jwot
줠	jwol
줡	jwolk
줢	jwolm
줣	jwolp
줤	jwols
줥	jwolt
줦	jwolp
줧	jwolh
줨	jwom
줩	jwop
줪	jwops
줫	jwos
줬	jwoss
줭	jwong
줮	jwoj
줯	jwoch
줰	jwok
줱	jwot
줲	jwop
줳	jwoh
줴	jwe
줵	jwek
줶	jwekk
줷	jweks
줸	jwen
줹	jwenj
줺	jwenh
줻	jwet
줼	jwel
줽	jwelk
줾	jwelm
줿	jwelp
쥀	jwels
쥁	jwelt
쥂	jwelp
쥃	jwelh
쥄	jwem
쥅	jwep
쥆	jweps
쥇	jwes
쥈	jwess
쥉	jweng
쥊	jwej
쥋	jwech
쥌	jwek
쥍	jwet
쥎	jwep
쥏	jweh
쥐	jwi
쥑	jwik
쥒	jwikk
쥓	jwiks
쥔	jwin
쥕	jwinj
쥖	jwinh
쥗	jwit
쥘	jwil
쥙	jwilk
쥚	jwilm
쥛	jwilp
쥜	jwils
쥝	jwilt
쥞	jwilp
쥟	jwilh
쥠	jwim
쥡	jwip
쥢	jwips
쥣	jwis
쥤	jwiss
쥥	jwing
쥦	jwij
쥧	jwich
쥨	jwik
쥩	jwit
쥪	jwip
쥫	jwih
쥬	jyu
쥭	jyuk
쥮	jyukk
쥯	jyuks
쥰	jyun
쥱	jyunj
쥲	jyunh
쥳	jyut
쥴	jyul
쥵	jyulk
쥶	jyulm
쥷	jyulp
쥸	jyuls
쥹	jyult
쥺	jyulp
쥻	jyulh
쥼	jyum
쥽	jyup
쥾	jyups
쥿	jyus
즀	jyuss
즁	jyung
즂	jyuj
즃	jyuch
즄	jyuk
즅	jyut
즆	jyup
즇	jyuh
즈	jeu
즉	jeuk
즊	jeukk
즋	jeuks
즌	jeun
즍	jeunj
즎	jeunh
즏	jeut
즐	jeul
즑	jeulk
즒	jeulm
즓	jeulp
즔	jeuls
즕	jeult
즖	jeulp
즗	jeulh
즘	jeum
즙	jeup
즚	jeups
즛	jeus
즜	jeuss
증	jeung
즞	jeuj
즟	jeuch
즠	jeuk
즡	jeut
즢	jeup
즣	jeuh
즤	jui
즥	juik
즦	juikk
즧	juiks
즨	juin
즩	juinj
즪	juinh
즫	juit
즬	juil
즭	juilk
즮	juilm
즯	juilp
즰	juils
즱	juilt
즲	juilp
즳	juilh
즴	juim
즵	juip
즶	juips
즷	juis
즸	juiss
즹	juing
즺	juij
즻	juich
즼	juik
즽	juit
즾	juip
즿	juih
지	ji
직	jik
짂	jikk
짃	jiks
진	jin
짅	jinj
짆	jinh
짇	jit
질	jil
짉	jilk
짊	jilm
짋	jilp
짌	jils
짍	jilt
짎	jilp
짏	jilh
짐	jim
집	jip
짒	jips
짓	jis
짔	jiss
징	jing
짖	jij
짗	jich
짘	jik
짙	jit
짚	jip
짛	jih
짜	jja
짝	jjak
짞	jjakk
짟	jjaks
짠	jjan
짡	jjanj
짢	jjanh
짣	jjat
짤	jjal
짥	jjalk
짦	jjalm
짧	jjalp
짨	jjals
짩	jjalt
짪	jjalp
짫	jjalh
짬	jjam
짭	jjap
짮	jjaps
짯	jjas
짰	jjass
짱	jjang
짲	jjaj
짳	jjach
짴	jjak
짵	jjat
짶	jjap
짷	jjah
째	jjae
짹	jjaek
짺	jjaekk
짻	jjaeks
짼	jjaen
짽	jjaenj
짾	jjaenh
짿	jjaet
쨀	jjael
쨁	jjaelk
쨂	jjaelm
쨃	jjaelp
쨄	jjaels
쨅	jjaelt
쨆	jjaelp
쨇	jjaelh
쨈	jjaem
쨉	jjaep
쨊	jjaeps
쨋	jjaes
쨌	jjaess
쨍	jjaeng
쨎	jjaej
쨏	jjaech
쨐	jjaek
쨑	jjaet
쨒	jjaep
쨓	jjaeh
쨔	jjya
쨕	jjyak
쨖	jjyakk
쨗	jjyaks
쨘	jjyan
쨙	jjyanj
쨚	jjyanh
쨛	jjyat
쨜	jjyal
쨝	jjyalk
쨞	jjyalm
쨟	jjyalp
쨠	jjyals
쨡	jjyalt
쨢	jjyalp
쨣	jjyalh
쨤	jjyam
쨥	jjyap
쨦	jjyaps
쨧	jjyas
쨨	jjyass
쨩	jjyang
쨪	jjyaj
쨫	jjyach
쨬	jjyak
쨭	jjyat
쨮	jjyap
쨯	jjyah
쨰	jjyae
쨱	jjyaek
쨲	jjyaekk
쨳	jjyaeks
쨴	jjyaen
쨵	jjyaenj
쨶	jjyaenh
쨷	jjyaet
쨸	jjyael
쨹	jjyaelk
쨺	jjyaelm
쨻	jjyaelp
쨼	jjyaels
쨽	jjyaelt
쨾	jjyaelp
쨿	jjyaelh
쩀	jjyaem
쩁	jjyaep
쩂	jjyaeps
쩃	jjyaes
쩄	jjyaess
쩅	jjyaeng
쩆	jjyaej
쩇	jjyaech
쩈	jjyaek
쩉	jjyaet
쩊	jjyaep
쩋	jjyaeh
쩌	jjeo
쩍	jjeok
쩎	jjeokk
쩏	jjeoks
쩐	jjeon
쩑	jjeonj
쩒	jjeonh
쩓	jjeot
쩔	jjeol
쩕	jjeolk
쩖	jjeolm
쩗	jjeolp
쩘	jjeols
쩙	jjeolt
쩚	jjeolp
쩛	jjeolh
쩜	jjeom
쩝	jjeop
쩞	jjeops
쩟	jjeos
쩠	jjeoss
쩡	jjeong
쩢	jjeoj
쩣	jjeoch
쩤	jjeok
쩥	jjeot
쩦	jjeop
쩧	jjeoh
쩨	jje
쩩	jjek
쩪	jjekk
쩫	jjeks
쩬	jjen
쩭	jjenj
쩮	jjenh
쩯	jjet
쩰	jjel
쩱	jjelk
쩲	jjelm
쩳	jjelp
쩴	jjels
쩵	jjelt
쩶	jjelp
쩷	jjelh
쩸	jjem
쩹	jjep
쩺	jjeps
쩻	jjes
쩼	jjess
쩽	jjeng
쩾	jjej
쩿	jjech
쪀	jjek
쪁	jjet
쪂	jjep
쪃	jjeh
쪄	jjyeo
쪅	jjyeok
쪆	jjyeokk
쪇	jjyeoks
쪈	jjyeon
쪉	jjyeonj
쪊	jjyeonh
쪋	jjyeot
쪌	jjyeol
쪍	jjyeolk
쪎	jjyeolm
쪏	jjyeolp
쪐	jjyeols
쪑	jjyeolt
쪒	jjyeolp
쪓	jjyeolh
쪔	jjyeom
쪕	jjyeop
쪖	jjyeops
쪗	jjyeos
쪘	jjyeoss
쪙	jjyeong
쪚	jjyeoj
쪛	jjyeoch
쪜	jjyeok
쪝	jjyeot
쪞	jjyeop
쪟	jjyeoh
쪠	jjye
쪡	jjyek
쪢	jjyekk
쪣	jjyeks
쪤	jjyen
쪥	jjyenj
쪦	jjyenh
쪧	jjyet
쪨	jjyel
쪩	jjyelk
쪪	jjyelm
쪫	jjyelp
쪬	jjyels
쪭	jjyelt
쪮	jjyelp
쪯	jjyelh
쪰	jjyem
쪱	jjyep
쪲	jjyeps
쪳	jjyes
쪴	jjyess
쪵	jjyeng
쪶	jjyej
쪷	jjyech
쪸	jjyek
쪹	jjyet
쪺	jjyep
쪻	jjyeh
쪼	jjo
쪽	jjok
쪾	jjokk
쪿	jjoks
쫀	jjon
쫁	jjonj
쫂	jjonh
쫃	jjot
쫄	jjol
쫅	jjolk
쫆	jjolm
쫇	jjolp
쫈	jjols
쫉	jjolt
쫊	jjolp
쫋	jjolh
쫌	jjom
쫍	jjop
쫎	jjops
쫏	jjos
쫐	jjoss
쫑	jjong
쫒	jjoj
쫓	jjoch
쫔	jjok
쫕	jjot
쫖	jjop
쫗	jjoh
쫘	jjwa
쫙	jjwak
쫚	jjwakk
쫛	jjwaks
쫜	jjwan
쫝	jjwanj
쫞	jjwanh
쫟	jjwat
쫠	jjwal
쫡	jjwalk
쫢	jjwalm
쫣	jjwalp
쫤	jjwals
쫥	jjwalt
쫦	jjwalp
쫧	jjwalh
쫨	jjwam
쫩	jjwap
쫪	jjwaps
쫫	jjwas
쫬	jjwass
쫭	jjwang
쫮	jjwaj
쫯	jjwach
쫰	jjwak
쫱	jjwat
쫲	jjwap
쫳	jjwah
쫴	jjwae
쫵	jjwaek
쫶	jjwaekk
쫷	jjwaeks
쫸	jjwaen
쫹	jjwaenj
쫺	jjwaenh
쫻	jjwaet
쫼	jjwael
쫽	jjwaelk
쫾	jjwaelm
쫿	jjwaelp
쬀	jjwaels
쬁	jjwaelt
쬂	jjwaelp
쬃	jjwaelh
쬄	jjwaem
쬅	jjwaep
쬆	jjwaeps
쬇	jjwaes
쬈	jjwaess
쬉	jjwaeng
쬊	jjwaej
쬋	jjwaech
쬌	jjwaek
쬍	jjwaet
쬎	jjwaep
쬏	jjwaeh
쬐	jjoe
쬑	jjoek
쬒	jjoekk
쬓	jjoeks
쬔	jjoen
쬕	jjoenj
쬖	jjoenh
쬗	jjoet
쬘	jjoel
쬙	jjoelk
쬚	jjoelm
쬛	jjoelp
쬜	jjoels
쬝	jjoelt
쬞	jjoelp
쬟	jjoelh
쬠	jjoem
쬡	jjoep
쬢	jjoeps
쬣	jjoes
쬤	jjoess
쬥	jjoeng
쬦	jjoej
쬧	jjoech
쬨	jjoek
쬩	jjoet
쬪	jjoep
쬫	jjoeh
쬬	jjyo
쬭	jjyok
쬮	jjyokk
쬯	jjyoks
쬰	jjyon
쬱	jjyonj
쬲	jjyonh
쬳	jjyot
쬴	jjyol
쬵	jjyolk
쬶	jjyolm
쬷	jjyolp
쬸	jjyols
쬹	jjyolt
쬺	jjyolp
쬻	jjyolh
쬼	jjyom
쬽	jjyop
쬾	jjyops
쬿	jjyos
쭀	jjyoss
쭁	jjyong
쭂	jjyoj
쭃	jjyoch
쭄	jjyok
쭅	jjyot
쭆	jjyop
쭇	jjyoh
쭈	jju
쭉	jjuk
쭊	jjukk
쭋	jjuks
쭌	jjun
쭍	jjunj
쭎	jjunh
쭏	jjut
쭐	jjul
쭑	jjulk
쭒	jjulm
쭓	jjulp
쭔	jjuls
쭕	jjult
쭖	jjulp
쭗	jjulh
쭘	jjum
쭙	jjup
쭚	jjups
쭛	jjus
쭜	jjuss
쭝	jjung
쭞	jjuj
쭟	jjuch
쭠	jjuk
쭡	jjut
쭢	jjup
쭣	jjuh
쭤	jjwo
쭥	jjwok
쭦	jjwokk
쭧	jjwoks
쭨	jjwon
쭩	jjwonj
쭪	jjwonh
쭫	jjwot
쭬	jjwol
쭭	jjwolk
쭮	jjwolm
쭯	jjwolp
쭰	jjwols
쭱	jjwolt
쭲	jjwolp
쭳	jjwolh
쭴	jjwom
쭵	jjwop
쭶	jjwops
쭷	jjwos
쭸	jjwoss
쭹	jjwong
쭺	jjwoj
쭻	jjwoch
쭼	jjwok
쭽	jjwot
쭾	jjwop
쭿	jjwoh
쮀	jjwe
쮁	jjwek
쮂	jjwekk
쮃	jjweks
쮄	jjwen
쮅	jjwenj
쮆	jjwenh
쮇	jjwet
쮈	jjwel
쮉	jjwelk
쮊	jjwelm
쮋	jjwelp
쮌	jjwels
쮍	jjwelt
쮎	jjwelp
쮏	jjwelh
쮐	jjwem
쮑	jjwep
쮒	jjweps
쮓	jjwes
쮔	jjwess
쮕	jjweng
쮖	jjwej
쮗	jjwech
쮘	jjwek
쮙	jjwet
쮚	jjwep
쮛	jjweh
쮜	jjwi
쮝	jjwik
쮞	jjwikk
쮟	jjwiks
쮠	jjwin
쮡	jjwinj
쮢	jjwinh
쮣	jjwit
쮤	jjwil
쮥	jjwilk
쮦	jjwilm
쮧	jjwilp
쮨	jjwils
쮩	jjwilt
쮪	jjwilp
쮫	jjwilh
쮬	jjwim
쮭	jjwip
쮮	jjwips
쮯	jjwis
쮰	jjwiss
쮱	jjwing
쮲	jjwij
쮳	jjwich
쮴	jjwik
쮵	jjwit
쮶	jjwip
쮷	jjwih
쮸	jjyu
쮹	jjyuk
쮺	jjyukk
쮻	jjyuks
쮼	jjyun
쮽	jjyunj
쮾	jjyunh
쮿	jjyut
쯀	jjyul
쯁	jjyulk
쯂	jjyulm
쯃	jjyulp
쯄	jjyuls
쯅	jjyult
쯆	jjyulp
쯇	jjyulh
쯈	jjyum
쯉	jjyup
쯊	jjyups
쯋	jjyus
쯌	jjyuss
쯍	jjyung
쯎	jjyuj
쯏	jjyuch
쯐	jjyuk
쯑	jjyut
쯒	jjyup
쯓	jjyuh
쯔	jjeu
쯕	jjeuk
쯖	jjeukk
쯗	jjeuks
쯘	jjeun
쯙	jjeunj
쯚	jjeunh
쯛	jjeut
쯜	jjeul
쯝	jjeulk
쯞	jjeulm
쯟	jjeulp
쯠	jjeuls
쯡	jjeult
쯢	jjeulp
쯣	jjeulh
쯤	jjeum
쯥	jjeup
쯦	jjeups
쯧	jjeus
쯨	jjeuss
쯩	jjeung
쯪	jjeuj
쯫	jjeuch
쯬	jjeuk
쯭	jjeut
쯮	jjeup
쯯	jjeuh
쯰	jjui
쯱	jjuik
쯲	jjuikk
쯳	jjuiks
쯴	jjuin
쯵	jjuinj
쯶	jjuinh
쯷	jjuit
쯸	jjuil
쯹	jjuilk
쯺	jjuilm
쯻	jjuilp
쯼	jjuils
쯽	jjuilt
쯾	jjuilp
쯿	jjuilh
찀	jjuim
찁	jjuip
찂	jjuips
찃	jjuis
찄	jjuiss
찅	jjuing
찆	jjuij
찇	jjuich
찈	jjuik
찉	jjuit
찊	jjuip
찋	jjuih
찌	jji
찍	jjik
찎	jjikk
찏	jjiks
찐	jjin
찑	jjinj
찒	jjinh
찓	jjit
찔	jjil
찕	jjilk
찖	jjilm
찗	jjilp
찘	jjils
찙	jjilt
찚	jjilp
찛	jjilh
찜	jjim
찝	jjip
찞	jjips
찟	jjis
찠	jjiss
찡	jjing
찢	jjij
찣	jjich
찤	jjik
찥	jjit
찦	jjip
찧	jjih
차	cha
착	chak
찪	chakk
찫	chaks
찬	chan
찭	chanj
찮	chanh
찯	chat
찰	chal
찱	chalk
찲	chalm
찳	chalp
찴	chals
찵	chalt
찶	chalp
찷	chalh
참	cham
찹	chap
찺	chaps
찻	chas
찼	chass
창	chang
찾	chaj
찿	chach
챀	chak
챁	chat
챂	chap
챃	chah
채	chae
책	chaek
챆	chaekk
챇	chaeks
챈	chaen
챉	chaenj
챊	chaenh
챋	chaet
챌	chael
챍	chaelk
챎	chaelm
챏	chaelp
챐	chaels
챑	chaelt
챒	chaelp
챓	chaelh
챔	chaem
챕	chaep
챖	chaeps
챗	chaes
챘	chaess
챙	chaeng
챚	chaej
챛	chaech
챜	chaek
챝	chaet
챞	chaep
챟	chaeh
챠	chya
챡	chyak
챢	chyakk
챣	chyaks
챤	chyan
챥	chyanj
챦	chyanh
챧	chyat
챨	chyal
챩	chyalk
챪	chyalm
챫	chyalp
챬	chyals
챭	chyalt
챮	chyalp
챯	chyalh
챰	chyam
챱	chyap
챲	chyaps
챳	chyas
챴	chyass
챵	chyang
챶	chyaj
챷	chyach
챸	chyak
챹	chyat
챺	chyap
챻	chyah
챼	chyae
챽	chyaek
챾	chyaekk
챿	chyaeks
첀	chyaen
첁	chyaenj
첂	chyaenh
첃	chyaet
첄	chyael
첅	chyaelk
첆	chyaelm
첇	chyaelp
첈	chyaels
첉	chyaelt
첊	chyaelp
첋	chyaelh
첌	chyaem
첍	chyaep
첎	chyaeps
첏	chyaes
첐	chyaess
첑	chyaeng
첒	chyaej
첓	chyaech
첔	chyaek
첕	chyaet
첖	chyaep
첗	chyaeh
처	cheo
척	cheok
첚	cheokk
첛	cheoks
천	cheon
첝	cheonj
첞	cheonh
첟	cheot
철	cheol
첡	cheolk
첢	cheolm
첣	cheolp
첤	cheols
첥	cheolt
첦	cheolp
첧	cheolh
첨	cheom
첩	cheop
첪	cheops
첫	cheos
첬	cheoss
청	cheong
첮	cheoj
첯	cheoch
첰	cheok
첱	cheot
첲	cheop
첳	cheoh
체	che
첵	chek
첶	chekk
첷	cheks
첸	chen
첹	chenj
첺	chenh
첻	chet
첼	chel
첽	chelk
첾	chelm
첿	chelp
쳀	chels
쳁	chelt
쳂	chelp
쳃	chelh
쳄	chem
쳅	chep
쳆	cheps
쳇	ches
쳈	chess
쳉	cheng
쳊	chej
쳋	chech
쳌	chek
쳍	chet
쳎	chep
쳏	cheh
쳐	chyeo
쳑	chyeok
쳒	chyeokk
쳓	chyeoks
쳔	chyeon
쳕	chyeonj
쳖	chyeonh
쳗	chyeot
쳘	chyeol
쳙	chyeolk
쳚	chyeolm
쳛	chyeolp
쳜	chyeols
쳝	chyeolt
쳞	chyeolp
쳟	chyeolh
쳠	chyeom
쳡	chyeop
쳢	chyeops
쳣	chyeos
쳤	chyeoss
쳥	chyeong
쳦	chyeoj
쳧	chyeoch
쳨	chyeok
쳩	chyeot
쳪	chyeop
쳫	chyeoh
쳬	chye
쳭	chyek
쳮	chyekk
쳯	chyeks
쳰	chyen
쳱	chyenj
쳲	chyenh
쳳	chyet
쳴	chyel
쳵	chyelk
쳶	chyelm
쳷	chyelp
쳸	chyels
쳹	chyelt
쳺	chyelp
쳻	chyelh
쳼	chyem
쳽	chyep
쳾	chyeps
쳿	chyes
촀	chyess
촁	chyeng
촂	chyej
촃	chyech
촄	chyek
촅	chyet
촆	chyep
촇	chyeh
초	cho
촉	chok
촊	chokk
촋	choks
촌	chon
촍	chonj
촎	chonh
촏	chot
촐	chol
촑	cholk
촒	cholm
촓	cholp
촔	chols
촕	cholt
촖	cholp
촗	cholh
촘	chom
촙	chop
촚	chops
촛	chos
촜	choss
총	chong
촞	choj
촟	choch
촠	chok
촡	chot
촢	chop
촣	choh
촤	chwa
촥	chwak
촦	chwakk
촧	chwaks
촨	chwan
촩	chwanj
촪	chwanh
촫	chwat
촬	chwal
촭	chwalk
촮	chwalm
촯	chwalp
촰	chwals
촱	chwalt
촲	chwalp
촳	chwalh
촴	chwam
촵	chwap
촶	chwaps
촷	chwas
촸	chwass
촹	chwang
촺	chwaj
촻	chwach
촼	chwak
촽	chwat
촾	chwap
촿	chwah
쵀	chwae
쵁	chwaek
쵂	chwaekk
쵃	chwaeks
쵄	chwaen
쵅	chwaenj
쵆	chwaenh
쵇	chwaet
쵈	chwael
쵉	chwaelk
쵊	chwaelm
쵋	chwaelp
쵌	chwaels
쵍	chwaelt
쵎	chwaelp
쵏	chwaelh
쵐	chwaem
쵑	chwaep
쵒	chwaeps
쵓	chwaes
쵔	chwaess
쵕	chwaeng
쵖	chwaej
쵗	chwaech
쵘	chwaek
쵙	chwaet
쵚	chwaep
쵛	chwaeh
최	choe
쵝	choek
쵞	choekk
쵟	choeks
쵠	choen
쵡	choenj
쵢	choenh
쵣	choet
쵤	choel
쵥	choelk
쵦	choelm
쵧	choelp
쵨	choels
쵩	choelt
쵪	choelp
쵫	choelh
쵬	choem
쵭	choep
쵮	choeps
쵯	choes
쵰	choess
쵱	choeng
쵲	choej
쵳	choech
쵴	choek
쵵	choet
쵶	choep
쵷	choeh
쵸	chyo
쵹	chyok
쵺	chyokk
쵻	chyoks
쵼	chyon
쵽	chyonj
쵾	chyonh
쵿	chyot
춀	chyol
춁	chyolk
춂	chyolm
춃	chyolp
춄	chyols
춅	chyolt
춆	chyolp
춇	chyolh
춈	chyom
춉	chyop
춊	chyops
춋	chyos
춌	chyoss
춍	chyong
춎	chyoj
춏	chyoch
춐	chyok
춑	chyot
춒	chyop
춓	chyoh
추	chu
축	chuk
춖	chukk
춗	chuks
춘	chun
춙	chunj
춚	chunh
춛	chut
출	chul
춝	chulk
춞	chulm
춟	chulp
춠	chuls
춡	chult
춢	chulp
춣	chulh
춤	chum
춥	chup
춦	chups
춧	chus
춨	chuss
충	chung
춪	chuj
춫	chuch
춬	chuk
춭	chut
춮	chup
춯	chuh
춰	chwo
춱	chwok
춲	chwokk
춳	chwoks
춴	chwon
춵	chwonj
춶	chwonh
춷	chwot
춸	chwol
춹	chwolk
춺	chwolm
춻	chwolp
춼	chwols
춽	chwolt
춾	chwolp
춿	chwolh
췀	chwom
췁	chwop
췂	chwops
췃	chwos
췄	chwoss
췅	chwong
췆	chwoj
췇	chwoch
췈	chwok
췉	chwot
췊	chwop
췋	chwoh
췌	chwe
췍	chwek
췎	chwekk
췏	chweks
췐	chwen
췑	chwenj
췒	chwenh
췓	chwet
췔	chwel
췕	chwelk
췖	chwelm
췗	chwelp
췘	chwels
췙	chwelt
췚	chwelp
췛	chwelh
췜	chwem
췝	chwep
췞	chweps
췟	chwes
췠	chwess
췡	chweng
췢	chwej
췣	chwech
췤	chwek
췥	chwet
췦	chwep
췧	chweh
취	chwi
췩	chwik
췪	chwikk
췫	chwiks
췬	chwin
췭	chwinj
췮	chwinh
췯	chwit
췰	chwil
췱	chwilk
췲	chwilm
췳	chwilp
췴	chwils
췵	chwilt
췶	chwilp
췷	chwilh
췸	chwim
췹	chwip
췺	chwips
췻	chwis
췼	chwiss
췽	chwing
췾	chwij
췿	chwich
츀	chwik
츁	chwit
츂	chwip
츃	chwih
츄	chyu
츅	chyuk
츆	chyukk
츇	chyuks
츈	chyun
츉	chyunj
츊	chyunh
츋	chyut
츌	chyul
츍	chyulk
츎	chyulm
츏	chyulp
츐	chyuls
츑	chyult
츒	chyulp
츓	chyulh
츔	chyum
츕	chyup
츖	chyups
츗	chyus
츘	chyuss
츙	chyung
츚	chyuj
츛	chyuch
츜	chyuk
츝	chyut
츞	chyup
츟	chyuh
츠	cheu
측	cheuk
츢	cheukk
츣	cheuks
츤	cheun
츥	cheunj
츦	cheunh
츧	cheut
츨	cheul
츩	cheulk
츪	cheulm
츫	cheulp
츬	cheuls
츭	cheult
츮	cheulp
츯	cheulh
츰	cheum
츱	cheup
츲	cheups
츳	cheus
츴	cheuss
층	cheung
츶	cheuj
츷	cheuch
츸	cheuk
츹	cheut
츺	cheup
츻	cheuh
츼	chui
츽	chuik
츾	chuikk
츿	chuiks
칀	chuin
칁	chuinj
칂	chuinh
칃	chuit
칄	chuil
칅	chuilk
칆	chuilm
칇	chuilp
칈	chuils
칉	chuilt
칊	chuilp
칋	chuilh
칌	chuim
칍	chuip
칎	chuips
칏	chuis
칐	chuiss
칑	chuing
칒	chuij
칓	chuich
칔	chuik
칕	chuit
칖	chuip
칗	chuih
치	chi
칙	chik
칚	chikk
칛	chiks
친	chin
칝	chinj
칞	chinh
칟	chit
칠	chil
칡	chilk
칢	chilm
칣	chilp
칤	chils
칥	chilt
칦	chilp
칧	chilh
침	chim
칩	chip
칪	chips
칫	chis
칬	chiss
칭	ching
칮	chij
칯	chich
칰	chik
칱	chit
칲	chip
칳	chih
카	ka
칵	kak
칶	kakk
칷	kaks
칸	kan
칹	kanj
칺	kanh
칻	kat
칼	kal
칽	kalk
칾	kalm
칿	kalp
캀	kals
캁	kalt
캂	kalp
캃	kalh
캄	kam
캅	kap
캆	kaps
캇	kas
캈	kass
캉	kang
캊	kaj
캋	kach
캌	kak
캍	kat
캎	kap
캏	kah
캐	kae
캑	kaek
캒	kaekk
캓	kaeks
캔	kaen
캕	kaenj
캖	kaenh
캗	kaet
캘	kael
캙	kaelk
캚	kaelm
캛	kaelp
캜	kaels
캝	kaelt
캞	kaelp
캟	kaelh
캠	kaem
캡	kaep
캢	kaeps
캣	kaes
캤	kaess
캥	kaeng
캦	kaej
캧	kaech
캨	kaek
캩	kaet
캪	kaep
캫	kaeh
캬	kya
캭	kyak
캮	kyakk
캯	kyaks
캰	kyan
캱	kyanj
캲	kyanh
캳	kyat
캴	kyal
캵	kyalk
캶	kyalm
캷	kyalp
캸	kyals
캹	kyalt
캺	kyalp
캻	kyalh
캼	kyam
캽	kyap
캾	kyaps
캿	kyas
컀	kyass
컁	kyang
컂	kyaj
컃	kyach
컄	kyak
컅	kyat
컆	kyap
컇	kyah
컈	kyae
컉	kyaek
컊	kyaekk
컋	kyaeks
컌	kyaen
컍	kyaenj
컎	kyaenh
컏	kyaet
컐	kyael
컑	kyaelk
컒	kyaelm
컓	kyaelp
컔	kyaels
컕	kyaelt
컖	kyaelp
컗	kyaelh
컘	kyaem
컙	kyaep
컚	kyaeps
컛	kyaes
컜	kyaess
컝	kyaeng
컞	kyaej
컟	kyaech
컠	kyaek
컡	kyaet
컢	kyaep
컣	kyaeh
커	keo
컥	keok
컦	keokk
컧	keoks
컨	keon
컩	keonj
컪	keonh
컫	keot
컬	keol
컭	keolk
컮	keolm
컯	keolp
컰	keols
컱	keolt
컲	keolp
컳	keolh
컴	keom
컵	keop
컶	keops
컷	keos
컸	keoss
컹	keong
컺	keoj
컻	keoch
컼	keok
컽	keot
컾	keop
컿	keoh
케	ke
켁	kek
켂	kekk
켃	keks
켄	ken
켅	kenj
켆	kenh
켇	ket
켈	kel
켉	kelk
켊	kelm
켋	kelp
켌	kels
켍	kelt
켎	kelp
켏	kelh
켐	kem
켑	kep
켒	keps
켓	kes
켔	kess
켕	keng
켖	kej
켗	kech
켘	kek
켙	ket
켚	kep
켛	keh
켜	kyeo
켝	kyeok
켞	kyeokk
켟	kyeoks
켠	kyeon
켡	kyeonj
켢	kyeonh
켣	kyeot
켤	kyeol
켥	kyeolk
켦	kyeolm
켧	kyeolp
켨	kyeols
켩	kyeolt
켪	kyeolp
켫	kyeolh
켬	kyeom
켭	kyeop
켮	kyeops
켯	kyeos
켰	kyeoss
켱	kyeong
켲	kyeoj
켳	kyeoch
켴	kyeok
켵	kyeot
켶	kyeop
켷	kyeoh
켸	kye
켹	kyek
켺	kyekk
켻	kyeks
켼	kyen
켽	kyenj
켾	kyenh
켿	kyet
콀	kyel
콁	kyelk
콂	kyelm
콃	kyelp
콄	kyels
콅	kyelt
콆	kyelp
콇	kyelh
콈	kyem
콉	kyep
콊	kyeps
콋	kyes
콌	kyess
콍	kyeng
콎	kyej
콏	kyech
콐	kyek
콑	kyet
콒	kyep
콓	kyeh
코	ko
콕	kok
콖	kokk
콗	koks
콘	kon
콙	konj
콚	konh
콛	kot
콜	kol
콝	kolk
콞	kolm
콟	kolp
콠	kols
콡	kolt
콢	kolp
콣	kolh
콤	kom
콥	kop
콦	kops
콧	kos
콨	koss
콩	kong
콪	koj
콫	koch
콬	kok
콭	kot
콮	kop
콯	koh
콰	kwa
콱	kwak
콲	kwakk
콳	kwaks
콴	kwan
콵	kwanj
콶	kwanh
콷	kwat
콸	kwal
콹	kwalk
콺	kwalm
콻	kwalp
콼	kwals
콽	kwalt
콾	kwalp
콿	kwalh
쾀	kwam
쾁	kwap
쾂	kwaps
쾃	kwas
쾄	kwass
쾅	kwang
쾆	kwaj
쾇	kwach
쾈	kwak
쾉	kwat
쾊	kwap
쾋	kwah
쾌	kwae
쾍	kwaek
쾎	kwaekk
쾏	kwaeks
쾐	kwaen
쾑	kwaenj
쾒	kwaenh
쾓	kwaet
쾔	kwael
쾕	kwaelk
쾖	kwaelm
쾗	kwaelp
쾘	kwaels
쾙	kwaelt
쾚	kwaelp
쾛	kwaelh
쾜	kwaem
쾝	kwaep
쾞	kwaeps
쾟	kwaes
쾠	kwaess
쾡	kwaeng
쾢	kwaej
쾣	kwaech
쾤	kwaek
쾥	kwaet
쾦	kwaep
쾧	kwaeh
쾨	koe
쾩	koek
쾪	koekk
쾫	koeks
쾬	koen
쾭	koenj
쾮	koenh
쾯	koet
쾰	koel
쾱	koelk
쾲	koelm
쾳	koelp
쾴	koels
쾵	koelt
쾶	koelp
쾷	koelh
쾸	koem
쾹	koep
쾺	koeps
쾻	koes
쾼	koess
쾽	koeng
쾾	koej
쾿	koech
쿀	koek
쿁	koet
쿂	koep
쿃	koeh
쿄	kyo
쿅	kyok
쿆	kyokk
쿇	kyoks
쿈	kyon
쿉	kyonj
쿊	kyonh
쿋	kyot
쿌	kyol
쿍	kyolk
쿎	kyolm
쿏	kyolp
쿐	kyols
쿑	kyolt
쿒	kyolp
쿓	kyolh
쿔	kyom
쿕	kyop
쿖	kyops
쿗	kyos
쿘	kyoss
쿙	kyong
쿚	kyoj
쿛	kyoch
쿜	kyok
쿝	kyot
쿞	kyop
쿟	kyoh
쿠	ku
쿡	kuk
쿢	kukk
쿣	kuks
쿤	kun
쿥	kunj
쿦	kunh
쿧	kut
쿨	kul
쿩	kulk
쿪	kulm
쿫	kulp
쿬	kuls
쿭	kult
쿮	kulp
쿯	kulh
쿰	kum
쿱	kup
쿲	kups
쿳	kus
쿴	kuss
쿵	kung
쿶	kuj
쿷	kuch
쿸	kuk
쿹	kut
쿺	kup
쿻	kuh
쿼	kwo
쿽	kwok
쿾	kwokk
쿿	kwoks
퀀	kwon
퀁	kwonj
퀂	kwonh
퀃	kwot
퀄	kwol
퀅	kwolk
퀆	kwolm
퀇	kwolp
퀈	kwols
퀉	kwolt
퀊	kwolp
퀋	kwolh
퀌	kwom
퀍	kwop
퀎	kwops
퀏	kwos
퀐	kwoss
퀑	kwong
퀒	kwoj
퀓	kwoch
퀔	kwok
퀕	kwot
퀖	kwop
퀗	kwoh
퀘	kwe
퀙	kwek
퀚	kwekk
퀛	kweks
퀜	kwen
퀝	kwenj
퀞	kwenh
퀟	kwet
퀠	kwel
퀡	kwelk
퀢	kwelm
퀣	kwelp
퀤	kwels
퀥	kwelt
퀦	kwelp
퀧	kwelh
퀨	kwem
퀩	kwep
퀪	kweps
퀫	kwes
퀬	kwess
퀭	kweng
퀮	kwej
퀯	kwech
퀰	kwek
퀱	kwet
퀲	kwep
퀳	kweh
퀴	kwi
퀵	kwik
퀶	kwikk
퀷	kwiks
퀸	kwin
퀹	kwinj
퀺	kwinh
퀻	kwit
퀼	kwil
퀽	kwilk
퀾	kwilm
퀿	kwilp
큀	kwils
큁	kwilt
큂	kwilp
큃	kwilh
큄	kwim
큅	kwip
큆	kwips
큇	kwis
큈	kwiss
큉	kwing
큊	kwij
큋	kwich
큌	kwik
큍	kwit
큎	kwip
큏	kwih
큐	kyu
큑	kyuk
큒	kyukk
큓	kyuks
큔	kyun
큕	kyunj
큖	kyunh
큗	kyut
큘	kyul
큙	kyulk
큚	kyulm
큛	kyulp
큜	kyuls
큝	kyult
큞	kyulp
큟	kyulh
큠	kyum
큡	kyup
큢	kyups
큣	kyus
큤	kyuss
큥	kyung
큦	kyuj
큧	kyuch
큨	kyuk
큩	kyut
큪	kyup
큫	kyuh
크	keu
큭	keuk
큮	keukk
큯	keuks
큰	keun
큱	keunj
큲	keunh
큳	keut
클	keul
큵	keulk
큶	keulm
큷	keulp
큸	keuls
큹	keult
큺	keulp
큻	keulh
큼	keum
큽	keup
큾	keups
큿	keus
킀	keuss
킁	keung
킂	keuj
킃	keuch
킄	keuk
킅	keut
킆	keup
킇	keuh
킈	kui
킉	kuik
킊	kuikk
킋	kuiks
킌	kuin
킍	kuinj
킎	kuinh
킏	kuit
킐	kuil
킑	kuilk
킒	kuilm
킓	kuilp
킔	kuils
킕	kuilt
킖	kuilp
킗	kuilh
킘	kuim
킙	kuip
킚	kuips
킛	kuis
킜	kuiss
킝	kuing
킞	kuij
킟	kuich
킠	kuik
킡	kuit
킢	kuip
킣	kuih
키	ki
킥	kik
킦	kikk
킧	kiks
킨	kin
킩	kinj
킪	kinh
킫	kit
킬	kil
킭	kilk
킮	kilm
킯	kilp
킰	kils
킱	kilt
킲	kilp
킳	kilh
킴	kim
킵	kip
킶	kips
킷	kis
킸	kiss
킹	king
킺	kij
킻	kich
킼	kik
킽	kit
킾	kip
킿	kih
타	ta
탁	tak
탂	takk
탃	taks
탄	tan
탅	tanj
탆	tanh
탇	tat
탈	tal
탉	talk
탊	talm
탋	talp
탌	tals
탍	talt
탎	talp
탏	talh
탐	tam
탑	tap
탒	taps
탓	tas
탔	tass
탕	tang
탖	taj
탗	tach
탘	ta
탙	tat
탚	tap
탛	tah
태	tae
택	taek
탞	taekk
탟	taeks
탠	taen
탡	taenj
탢	taenh
탣	taet
탤	tael
탥	taelk
탦	taelm
탧	taelp
탨	taels
탩	taelt
탪	taelp
탫	taelh
탬	taem
탭	taep
탮	taeps
탯	taes
탰	taess
탱	taeng
탲	taej
탳	taech
탴	taek
탵	taet
탶	taep
탷	taeh
탸	tya
탹	tyak
탺	tyakk
탻	tyaks
탼	tyan
탽	tyanj
탾	tyanh
탿	tyat
턀	tyal
턁	tyalk
턂	tyalm
턃	tyalp
턄	tyals
턅	tyalt
턆	tyalp
턇	tyalh
턈	tyam
턉	tyap
턊	tyaps
턋	tyas
턌	tyass
턍	tyang
턎	tyaj
턏	tyach
턐	tyak
턑	tyat
턒	tyap
턓	tyah
턔	tyae
턕	tyaek
턖	tyaekk
턗	tyaeks
턘	tyaen
턙	tyaenj
턚	tyaenh
턛	tyaet
턜	tyael
턝	tyaelk
턞	tyaelm
턟	tyaelp
턠	tyaels
턡	tyaelt
턢	tyaelp
턣	tyaelh
턤	tyaem
턥	tyaep
턦	tyaeps
턧	tyaes
턨	tyaess
턩	tyaeng
턪	tyaej
턫	tyaech
턬	tyaek
턭	tyaet
턮	tyaep
턯	tyaeh
터	teo
턱	teok
턲	teokk
턳	teoks
턴	teon
턵	teonj
턶	teonh
턷	teot
털	teol
턹	toelk
턺	teolm
턻	teolp
턼	teols
턽	teolt
턾	teolp
턿	teolh
텀	teom
텁	teop
텂	teops
텃	teos
텄	teoss
텅	teong
텆	teoj
텇	teoch
텈	teok
텉	teot
텊	teop
텋	teoh
테	te
텍	tek
텎	tekk
텏	teks
텐	ten
텑	tenj
텒	tenh
텓	tet
텔	tel
텕	telk
텖	telm
텗	telp
텘	tels
텙	telt
텚	telp
텛	telh
템	tem
텝	tep
텞	teps
텟	tes
텠	tess
텡	teng
텢	tej
텣	tech
텤	tek
텥	tet
텦	tep
텧	teh
텨	tyeo
텩	tyeok
텪	tyeokk
텫	tyoeks
텬	tyeon
텭	tyeonj
텮	tyeonh
텯	tyeot
텰	tyeol
텱	tyeolk
텲	tyeolm
텳	tyeolp
텴	tyeols
텵	tyeolt
텶	tyeolp
텷	tyeolh
텸	tyeom
텹	tyeop
텺	tyeops
텻	tyeos
텼	tyeoss
텽	tyeong
텾	tyeoj
텿	tyeoch
톀	tyeok
톁	tyeot
톂	tyeop
톃	tyeoh
톄	tye
톅	tyek
톆	tyekk
톇	tyeks
톈	tyen
톉	tyenj
톊	tyenh
톋	tyet
톌	tyel
톍	tyelk
톎	tyelm
톏	tyelp
톐	tyels
톑	tyelt
톒	tyelp
톓	tyelh
톔	tyem
톕	tyep
톖	tyeps
톗	tyes
톘	tyess
톙	tyeng
톚	tyej
톛	tyech
톜	tyek
톝	tyet
톞	tyep
톟	tyeh
토	to
톡	tok
톢	tokk
톣	toks
톤	ton
톥	tonj
톦	tonh
톧	tot
톨	tol
톩	tolk
톪	tolm
톫	tolp
톬	tols
톭	tolt
톮	tolp
톯	tolh
톰	tom
톱	top
톲	tops
톳	tos
톴	toss
통	tong
톶	toj
톷	toch
톸	tok
톹	tot
톺	top
톻	toh
톼	twa
톽	twak
톾	twakk
톿	twaks
퇀	twan
퇁	twanj
퇂	twanh
퇃	twat
퇄	twal
퇅	twalk
퇆	twalm
퇇	twalp
퇈	twals
퇉	twalt
퇊	twalp
퇋	twalh
퇌	twam
퇍	twap
퇎	twaps
퇏	twas
퇐	twass
퇑	twang
퇒	twaj
퇓	twach
퇔	twak
퇕	twat
퇖	twap
퇗	twah
퇘	twae
퇙	twaek
퇚	twaekk
퇛	twaeks
퇜	twaen
퇝	twaenj
퇞	twaenh
퇟	twaet
퇠	twael
퇡	twaelk
퇢	twaelm
퇣	twaelp
퇤	twaels
퇥	twaelt
퇦	twaelp
퇧	twaelh
퇨	twaem
퇩	twaep
퇪	twaeps
퇫	twaes
퇬	twaess
퇭	twaeng
퇮	twaej
퇯	twaech
퇰	twaek
퇱	twaet
퇲	twaep
퇳	twaeh
퇴	toe
퇵	toek
퇶	toekk
퇷	toeks
퇸	toen
퇹	toenj
퇺	toenh
퇻	toet
퇼	toel
퇽	toelk
퇾	toelm
퇿	toelp
툀	toels
툁	toelt
툂	toelp
툃	toelh
툄	toem
툅	toep
툆	toeps
툇	toes
툈	toess
툉	toeng
툊	toej
툋	toech
툌	toek
툍	toet
툎	toep
툏	toeh
툐	tyo
툑	tyok
툒	tyokk
툓	tyoks
툔	tyon
툕	tyonj
툖	tyonh
툗	tyot
툘	tyol
툙	tyolk
툚	tyolm
툛	tyolp
툜	tyols
툝	tyolt
툞	tyolp
툟	tyolh
툠	tyom
툡	tyop
툢	tyops
툣	tyos
툤	tyoss
툥	tyong
툦	tyoj
툧	tyoch
툨	tyok
툩	tyot
툪	tyop
툫	tyoh
투	tu
툭	tuk
툮	tukk
툯	tuks
툰	tun
툱	tunj
툲	tunh
툳	tut
툴	tul
툵	tulk
툶	tulm
툷	tulp
툸	tuls
툹	tult
툺	tulp
툻	tulh
툼	tum
툽	tup
툾	tups
툿	tus
퉀	tuss
퉁	tung
퉂	tuj
퉃	tuch
퉄	tuk
퉅	tut
퉆	tup
퉇	tuh
퉈	two
퉉	twok
퉊	twokk
퉋	twoks
퉌	twon
퉍	twonj
퉎	twonh
퉏	twot
퉐	twol
퉑	twolk
퉒	twolm
퉓	twolp
퉔	twols
퉕	twolt
퉖	twolp
퉗	twolh
퉘	twom
퉙	twop
퉚	twops
퉛	twos
퉜	twoss
퉝	twong
퉞	twoj
퉟	twoch
퉠	twok
퉡	twot
퉢	twop
퉣	twoh
퉤	twe
퉥	twek
퉦	twekk
퉧	tweks
퉨	twen
퉩	twenj
퉪	twenh
퉫	twet
퉬	twel
퉭	twelk
퉮	twelm
퉯	twelp
퉰	twels
퉱	twelt
퉲	twelp
퉳	twelh
퉴	twem
퉵	twep
퉶	tweps
퉷	twes
퉸	twess
퉹	tweng
퉺	twej
퉻	twech
퉼	twek
퉽	twet
퉾	twep
퉿	tweh
튀	twi
튁	twik
튂	twikk
튃	twiks
튄	twin
튅	twinj
튆	twinh
튇	twit
튈	twil
튉	twilk
튊	twilm
튋	twilp
튌	twils
튍	twilt
튎	twilp
튏	twilh
튐	twim
튑	twip
튒	twips
튓	twis
튔	twiss
튕	twing
튖	twij
튗	twich
튘	twik
튙	twit
튚	twip
튛	twih
튜	tyu
튝	tyuk
튞	tyukk
튟	tyuks
튠	tyun
튡	tyunj
튢	tyunh
튣	tyut
튤	tyul
튥	tyulk
튦	tyulm
튧	tyulp
튨	tyuls
튩	tyult
튪	tyulp
튫	tyulh
튬	tyum
튭	tyup
튮	tyups
튯	tyus
튰	tyuss
튱	tyung
튲	tyuj
튳	tyuch
튴	tyuk
튵	tyut
튶	tyup
튷	tyuh
트	teu
특	teuk
튺	teukk
튻	teuks
튼	teun
튽	teunj
튾	teunh
튿	teut
틀	teul
틁	teulk
틂	teulm
틃	teulp
틄	teuls
틅	teult
틆	teulp
틇	teulh
틈	teum
틉	teup
틊	teups
틋	teus
틌	teuss
틍	teung
틎	teuj
틏	teuch
틐	teuk
틑	teut
틒	teup
틓	teuh
틔	tui
틕	tuik
틖	tuikk
틗	tuiks
틘	tuin
틙	tuinj
틚	tuinh
틛	tuit
틜	tuil
틝	tuilk
틞	tuilm
틟	tuilp
틠	tuils
틡	tuilt
틢	tuilp
틣	tuilh
틤	tuim
틥	tuip
틦	tuips
틧	tuis
틨	tuiss
틩	tuing
틪	tuij
틫	tuich
틬	tuik
틭	tuit
틮	tuip
틯	tuih
티	ti
틱	tik
틲	tikk
틳	tiks
틴	tin
틵	tinj
틶	tinh
틷	tit
틸	til
틹	tilk
틺	tilm
틻	tilp
틼	tils
틽	tilt
틾	tilp
틿	tilh
팀	tim
팁	tip
팂	tips
팃	tis
팄	tiss
팅	ting
팆	tij
팇	tich
팈	tik
팉	tit
팊	tip
팋	tih
파	pa
팍	pak
팎	pakk
팏	paks
판	pan
팑	panj
팒	panh
팓	pat
팔	pal
팕	palk
팖	palm
팗	palp
팘	pals
팙	palt
팚	palp
팛	palh
팜	pam
팝	pap
팞	paps
팟	pas
팠	pass
팡	pang
팢	paj
팣	pach
팤	pak
팥	pat
팦	pap
팧	pah
패	pae
팩	paek
팪	paekk
팫	paeks
팬	paen
팭	paenj
팮	paenh
팯	paet
팰	pael
팱	paelk
팲	paelm
팳	paelp
팴	paels
팵	paelt
팶	paelp
팷	paelh
팸	paem
팹	paep
팺	paeps
팻	paes
팼	paess
팽	paeng
팾	paej
팿	paech
퍀	paek
퍁	paet
퍂	paep
퍃	paeh
퍄	pya
퍅	pyak
퍆	pyakk
퍇	pyaks
퍈	pyan
퍉	pyanj
퍊	pyanh
퍋	pyat
퍌	pyal
퍍	pyalk
퍎	pyalm
퍏	pyalp
퍐	pyals
퍑	pyalt
퍒	pyalp
퍓	pyalh
퍔	pyam
퍕	pyap
퍖	pyaps
퍗	pyas
퍘	pyass
퍙	pyang
퍚	pyaj
퍛	pyach
퍜	pyak
퍝	pyat
퍞	pyap
퍟	pyah
퍠	pyae
퍡	pyaek
퍢	pyaekk
퍣	pyaeks
퍤	pyaen
퍥	pyaenj
퍦	pyaenh
퍧	pyaet
퍨	pyael
퍩	pyaelk
퍪	pyaelm
퍫	pyaelp
퍬	pyaels
퍭	pyaelt
퍮	pyaelp
퍯	pyaelh
퍰	pyaem
퍱	pyaep
퍲	pyaeps
퍳	pyaes
퍴	pyaess
퍵	pyaeng
퍶	pyaej
퍷	pyaech
퍸	pyaek
퍹	pyaet
퍺	pyaep
퍻	pyaeh
퍼	peo
퍽	peok
퍾	peokk
퍿	peoks
펀	peon
펁	peonj
펂	peonh
펃	peot
펄	peol
펅	peolk
펆	peolm
펇	peolp
펈	peols
펉	peolt
펊	peolp
펋	peolh
펌	peom
펍	peop
펎	peops
펏	peos
펐	peoss
펑	peong
펒	peoj
펓	peoch
펔	peok
펕	peot
펖	peop
펗	peoh
페	pe
펙	pek
펚	pekk
펛	peks
펜	pen
펝	penj
펞	penh
펟	pet
펠	pel
펡	pelk
펢	pelm
펣	pelp
펤	pels
펥	pelt
펦	pelp
펧	pelh
펨	pem
펩	pep
펪	peps
펫	pes
펬	pess
펭	peng
펮	pej
펯	pech
펰	pek
펱	pet
펲	pep
펳	peh
펴	pyeo
펵	pyeok
펶	pyeokk
펷	pyeoks
편	pyeon
펹	pyeonj
펺	pyeonh
펻	pyeot
펼	pyeol
펽	pyeolk
펾	pyeolm
펿	pyeolp
폀	pyeols
폁	pyeolt
폂	pyeolp
폃	pyeolh
폄	pyeom
폅	pyeop
폆	pyeops
폇	pyeos
폈	pyeoss
평	pyeong
폊	pyeoj
폋	pyeoch
폌	pyeok
폍	pyeot
폎	pyeop
폏	pyeoh
폐	pye
폑	pyek
폒	pyekk
폓	pyeks
폔	pyen
폕	pyenj
폖	pyenh
폗	pyet
폘	pyel
폙	pyelk
폚	pyelm
폛	pyelp
폜	pyels
폝	pyelt
폞	pyelp
폟	pyelh
폠	pyem
폡	pyep
폢	pyeps
폣	pyes
폤	pyess
폥	pyeng
폦	pyej
폧	pyech
폨	pyek
폩	pyet
폪	pyep
폫	pyeh
포	po
폭	pok
폮	pokk
폯	poks
폰	pon
폱	ponj
폲	ponh
폳	pot
폴	pol
폵	polk
폶	polm
폷	polp
폸	pols
폹	polt
폺	polp
폻	polh
폼	pom
폽	pop
폾	pops
폿	pos
퐀	poss
퐁	pong
퐂	poj
퐃	poch
퐄	pok
퐅	pot
퐆	pop
퐇	poh
퐈	pwa
퐉	pwak
퐊	pwakk
퐋	pwaks
퐌	pwan
퐍	pwanj
퐎	pwanh
퐏	pwat
퐐	pwal
퐑	pwalk
퐒	pwalm
퐓	pwalp
퐔	pwals
퐕	pwalt
퐖	pwalp
퐗	pwalh
퐘	pwam
퐙	pwap
퐚	pwaps
퐛	pwas
퐜	pwass
퐝	pwang
퐞	pwaj
퐟	pwach
퐠	pwak
퐡	pwat
퐢	pwap
퐣	pwah
퐤	pwae
퐥	pwaek
퐦	pwaekk
퐧	pwaeks
퐨	pwaen
퐩	pwaenj
퐪	pwaenh
퐫	pwaet
퐬	pwael
퐭	pwaelk
퐮	pwaelm
퐯	pwaelp
퐰	pwaels
퐱	pwaelt
퐲	pwaelp
퐳	pwaelh
퐴	pwaem
퐵	pwaep
퐶	pwaeps
퐷	pwaes
퐸	pwaess
퐹	pwaeng
퐺	pwaej
퐻	pwaech
퐼	pwaek
퐽	pwaet
퐾	pwaep
퐿	pwaeh
푀	poe
푁	poek
푂	poekk
푃	poeks
푄	poen
푅	poenj
푆	poenh
푇	poet
푈	poel
푉	poelk
푊	poelm
푋	poelp
푌	poels
푍	poelt
푎	poelp
푏	poelh
푐	poem
푑	poep
푒	poeps
푓	poes
푔	poess
푕	poeng
푖	poej
푗	poech
푘	poek
푙	poet
푚	poep
푛	poeh
표	pyo
푝	pyok
푞	pyokk
푟	pyoks
푠	pyon
푡	pyonj
푢	pyonh
푣	pyot
푤	pyol
푥	pyolk
푦	pyolm
푧	pyolp
푨	pyols
푩	pyolt
푪	pyolp
푫	pyolh
푬	pyom
푭	pyop
푮	pyops
푯	pyos
푰	pyoss
푱	pyong
푲	pyoj
푳	pyoch
푴	pyok
푵	pyot
푶	pyop
푷	pyoh
푸	pu
푹	puk
푺	pukk
푻	puks
푼	pun
푽	punj
푾	punh
푿	put
풀	pul
풁	pulk
풂	pulm
풃	pulp
풄	puls
풅	pult
풆	pulp
풇	pulh
품	pum
풉	pup
풊	pups
풋	pus
풌	puss
풍	pung
풎	puj
풏	puch
풐	puk
풑	put
풒	pup
풓	puh
풔	pwo
풕	pwok
풖	pwokk
풗	pwoks
풘	pwon
풙	pwonj
풚	pwonh
풛	pwot
풜	pwol
풝	pwolk
풞	pwolm
풟	pwolp
풠	pwols
풡	pwolt
풢	pwolp
풣	pwolh
풤	pwom
풥	pwop
풦	pwops
풧	pwos
풨	pwoss
풩	pwong
풪	pwoj
풫	pwoch
풬	pwok
풭	pwot
풮	pwop
풯	pwoh
풰	pwe
풱	pwek
풲	pwekk
풳	pweks
풴	pwen
풵	pwenj
풶	pwenh
풷	pwet
풸	pwel
풹	pwelk
풺	pwelm
풻	pwelp
풼	pwels
풽	pwelt
풾	pwelp
풿	pwelh
퓀	pwem
퓁	pwep
퓂	pweps
퓃	pwes
퓄	pwess
퓅	pweng
퓆	pwej
퓇	pwech
퓈	pwek
퓉	pwet
퓊	pwep
퓋	pweh
퓌	pwi
퓍	pwik
퓎	pwikk
퓏	pwiks
퓐	pwin
퓑	pwinj
퓒	pwinh
퓓	pwit
퓔	pwil
퓕	pwilk
퓖	pwilm
퓗	pwilp
퓘	pwils
퓙	pwilt
퓚	pwilp
퓛	pwilh
퓜	pwim
퓝	pwip
퓞	pwips
퓟	pwis
퓠	pwiss
퓡	pwing
퓢	pwij
퓣	pwich
퓤	pwik
퓥	pwit
퓦	pwip
퓧	pwih
퓨	pyu
퓩	pyuk
퓪	pyukk
퓫	pyuks
퓬	pyun
퓭	pyunj
퓮	pyunh
퓯	pyut
퓰	pyul
퓱	pyulk
퓲	pyulm
퓳	pyulp
퓴	pyuls
퓵	pyult
퓶	pyulp
퓷	pyulh
퓸	pyum
퓹	pyup
퓺	pyups
퓻	pyus
퓼	pyuss
퓽	pyung
퓾	pyuj
퓿	pyuch
픀	pyuk
픁	pyut
픂	pyup
픃	pyuh
프	peu
픅	peuk
픆	peukk
픇	peuks
픈	peun
픉	peunj
픊	peunh
픋	peut
플	peul
픍	peulk
픎	peulm
픏	peulp
픐	peuls
픑	peult
픒	peulp
픓	peulh
픔	peum
픕	peup
픖	peups
픗	peus
픘	peuss
픙	peung
픚	peuj
픛	peuch
픜	peuk
픝	peut
픞	peup
픟	peuh
픠	pui
픡	puik
픢	puikk
픣	puiks
픤	puin
픥	puinj
픦	puinh
픧	puit
픨	puil
픩	puilk
픪	puilm
픫	puilp
픬	puils
픭	puilt
픮	puilp
픯	puilh
픰	puim
픱	puip
픲	puips
픳	puis
픴	puiss
픵	puing
픶	puij
픷	puich
픸	puik
픹	puit
픺	puip
픻	puih
피	pi
픽	pik
픾	pikk
픿	piks
핀	pin
핁	pinj
핂	pinh
핃	pit
필	pil
핅	pilk
핆	pilm
핇	pilp
핈	pils
핉	pilt
핊	pilp
핋	pilh
핌	pim
핍	pip
핎	pips
핏	pis
핐	piss
핑	ping
핒	pij
핓	pich
핔	pik
핕	pit
핖	pip
핗	pih
하	ha
학	hak
핚	hakk
핛	haks
한	han
핝	hanj
핞	hanh
핟	hat
할	hal
핡	halk
핢	halm
핣	halp
핤	hals
핥	halt
핦	halp
핧	halh
함	ham
합	hap
핪	haps
핫	has
핬	hass
항	hang
핮	haj
핯	hach
핰	hak
핱	hat
핲	hap
핳	hah
해	hae
핵	haek
핶	haekk
핷	haeks
핸	haen
핹	haenj
핺	haenh
핻	haet
핼	hael
핽	haelk
핾	haelm
핿	haelp
햀	haels
햁	haelt
햂	haelp
햃	haelh
햄	haem
햅	haep
햆	haeps
햇	haes
했	haess
행	haeng
햊	haej
햋	haech
햌	haek
햍	haet
햎	haep
햏	haeh
햐	hya
햑	hyak
햒	hyakk
햓	hyaks
햔	hyan
햕	hyanj
햖	hyanh
햗	hyat
햘	hyal
햙	hyalk
햚	hyalm
햛	hyalp
햜	hyals
햝	hyalt
햞	hyalp
햟	hyalh
햠	hyam
햡	hyap
햢	hyaps
햣	hyas
햤	hyass
향	hyang
햦	hyaj
햧	hyach
햨	hyak
햩	hyat
햪	hyap
햫	hyah
햬	hyae
햭	hyaek
햮	hyaekk
햯	hyaeks
햰	hyaen
햱	hyaenj
햲	hyaenh
햳	hyaet
햴	hyael
햵	hyaelk
햶	hyaelm
햷	hyaelp
햸	hyaels
햹	hyaelt
햺	hyaelp
햻	hyaelh
햼	hyaem
햽	hyaep
햾	hyaeps
햿	hyaes
헀	hyaess
헁	hyaeng
헂	hyaej
헃	hyaech
헄	hyaek
헅	hyaet
헆	hyaep
헇	hyaeh
허	heo
헉	heok
헊	heokk
헋	heoks
헌	heon
헍	heonj
헎	heonh
헏	heot
헐	heol
헑	heolk
헒	heolm
헓	heolp
헔	heols
헕	heolt
헖	heolp
헗	heolh
험	heom
헙	heop
헚	heops
헛	heos
헜	heoss
헝	heong
헞	heoj
헟	heoch
헠	heok
헡	heot
헢	heop
헣	heoh
헤	he
헥	hek
헦	hekk
헧	heks
헨	hen
헩	henj
헪	henh
헫	het
헬	hel
헭	helk
헮	helm
헯	help
헰	hels
헱	helt
헲	help
헳	helh
헴	hem
헵	hep
헶	heps
헷	hes
헸	hess
헹	heng
헺	hej
헻	hech
헼	hek
헽	het
헾	hep
헿	heh
혀	hyeo
혁	hyeok
혂	hyeokk
혃	hyeoks
현	hyeon
혅	hyeonj
혆	hyeonh
혇	hyeot
혈	hyeol
혉	hyeolk
혊	hyeolm
혋	hyeolp
혌	hyeols
혍	hyeolt
혎	hyeolp
혏	hyeolh
혐	hyeom
협	hyeop
혒	hyeops
혓	hyeos
혔	hyeoss
형	hyeong
혖	hyeoj
혗	hyeoch
혘	hyeok
혙	hyeot
혚	hyeop
혛	hyeoh
혜	hye
혝	hyek
혞	hyekk
혟	hyeks
혠	hyen
혡	hyenj
혢	hyenh
혣	hyet
혤	hyel
혥	hyelk
혦	hyelm
혧	hyelp
혨	hyels
혩	hyelt
혪	hyelp
혫	hyelh
혬	hyem
혭	hyep
혮	hyeps
혯	hyes
혰	hyess
혱	hyeng
혲	hyej
혳	hyech
혴	hyek
혵	hyet
혶	hyep
혷	hyeh
호	ho
혹	hok
혺	hokk
혻	hoks
혼	hon
혽	honj
혾	honh
혿	hot
홀	hol
홁	holk
홂	holm
홃	holp
홄	hols
홅	holt
홆	holp
홇	holh
홈	hom
홉	hop
홊	hops
홋	hos
홌	hoss
홍	hong
홎	hoj
홏	hoch
홐	hok
홑	hot
홒	hop
홓	hoh
화	hwa
확	hwak
홖	hwakk
홗	hwaks
환	hwan
홙	hwanj
홚	hwanh
홛	hwat
활	hwal
홝	hwalk
홞	hwalm
홟	hwalp
홠	hwals
홡	hwalt
홢	hwalp
홣	hwalh
홤	hwam
홥	hwap
홦	hwaps
홧	hwas
홨	hwass
황	hwang
홪	hwaj
홫	hwach
홬	hwak
홭	hwat
홮	hwap
홯	hwah
홰	hwae
홱	hwaek
홲	hwaekk
홳	hwaeks
홴	hwaen
홵	hwaenj
홶	hwaenh
홷	hwaet
홸	hwael
홹	hwaelk
홺	hwaelm
홻	hwaelp
홼	hwaels
홽	hwaelt
홾	hwaelp
홿	hwaelh
횀	hwaem
횁	hwaep
횂	hwaeps
횃	hwaes
횄	hwaess
횅	hwaeng
횆	hwaej
횇	hwaech
횈	hwaek
횉	hwaet
횊	hwaep
횋	hwaeh
회	hoe
획	hoek
횎	hoekk
횏	hoeks
횐	hoen
횑	hoenj
횒	hoenh
횓	hoet
횔	hoel
횕	hoelk
횖	hoelm
횗	hoelp
횘	hoels
횙	hoelt
횚	hoelp
횛	hoelh
횜	hoem
횝	hoep
횞	hoeps
횟	hoes
횠	hoess
횡	hoeng
횢	hoej
횣	hoech
횤	hoek
횥	hoet
횦	hoep
횧	hoeh
효	hyo
횩	hyok
횪	hyokk
횫	hyoks
횬	hyon
횭	hyonj
횮	hyonh
횯	hyot
횰	hyol
횱	hyolk
횲	hyolm
횳	hyolp
횴	hyols
횵	hyolt
횶	hyolp
횷	hyolh
횸	hyom
횹	hyop
횺	hyops
횻	hyos
횼	hyoss
횽	hyong
횾	hyoj
횿	hyoch
훀	hyok
훁	hyot
훂	hyop
훃	hyoh
후	hu
훅	huk
훆	hukk
훇	huks
훈	hun
훉	hunj
훊	hunh
훋	hut
훌	hul
훍	hulk
훎	hulm
훏	hulp
훐	huls
훑	hult
훒	hulp
훓	hulh
훔	hum
훕	hup
훖	hups
훗	hus
훘	huss
훙	hung
훚	huj
훛	huch
훜	huk
훝	hut
훞	hup
훟	huh
훠	hwo
훡	hwok
훢	hwokk
훣	hwoks
훤	hwon
훥	hwonj
훦	hwonh
훧	hwot
훨	hwol
훩	hwolk
훪	hwolm
훫	hwolp
훬	hwols
훭	hwolt
훮	hwolp
훯	hwolh
훰	hwom
훱	hwop
훲	hwops
훳	hwos
훴	hwoss
훵	hwong
훶	hwoj
훷	hwoch
훸	hwok
훹	hwot
훺	hwop
훻	hwoh
훼	hwe
훽	hwek
훾	hwekk
훿	hweks
휀	hwen
휁	hwenj
휂	hwenh
휃	hwet
휄	hwel
휅	hwelk
휆	hwelm
휇	hwelp
휈	hwels
휉	hwelt
휊	hwelp
휋	hwelh
휌	hwem
휍	hwep
휎	hweps
휏	hwes
휐	hwess
휑	hweng
휒	hwej
휓	hwech
휔	hwek
휕	hwet
휖	hwep
휗	hweh
휘	hwi
휙	hwik
휚	hwikk
휛	hwiks
휜	hwin
휝	hwinj
휞	hwinh
휟	hwit
휠	hwil
휡	hwilk
휢	hwilm
휣	hwilp
휤	hwils
휥	hwilt
휦	hwilp
휧	hwilh
휨	hwim
휩	hwip
휪	hwips
휫	hwis
휬	hwiss
휭	hwing
휮	hwij
휯	hwich
휰	hwik
휱	hwit
휲	hwip
휳	hwih
휴	hyu
휵	hyuk
휶	hyukk
휷	hyuks
휸	hyun
휹	hyunj
휺	hyunh
휻	hyut
휼	hyul
휽	hyulk
휾	hyulm
휿	hyulp
흀	hyuls
흁	hyult
흂	hyulp
흃	hyulh
흄	hyum
흅	hyup
흆	hyups
흇	hyus
흈	hyuss
흉	hyung
흊	hyuj
흋	hyuch
흌	hyuk
흍	hyut
흎	hyup
흏	hyuh
흐	heu
흑	heuk
흒	heukk
흓	heuks
흔	heun
흕	heunj
흖	heunh
흗	heut
흘	heul
흙	heulk
흚	heulm
흛	heulp
흜	heuls
흝	heult
흞	heulp
흟	heulh
흠	heum
흡	heup
흢	heups
흣	heus
흤	heuss
흥	heung
흦	heuj
흧	heuch
흨	heuk
흩	heut
흪	heup
흫	heuh
희	hui
흭	huik
흮	huikk
흯	huiks
흰	huin
흱	huinj
흲	huinh
흳	huit
흴	huil
흵	huilk
흶	huilm
흷	huilp
흸	huils
흹	huilt
흺	huilp
흻	huilh
흼	huim
흽	huip
흾	huips
흿	huis
힀	huiss
힁	huing
힂	huij
힃	huich
힄	huik
힅	huit
힆	huip
힇	huih
히	hi
힉	hik
힊	hikk
힋	hiks
힌	hin
힍	hinj
힎	hinh
힏	hit
힐	hil
힑	hilk
힒	hilm
힓	hilp
힔	hils
힕	hilt
힖	hilp
힗	hilh
힘	him
힙	hip
힚	hips
힛	his
힜	hiss
힝	hing
힞	hij
힟	hich
힠	hik
힡	hit
힢	hip
힣	hih
